cell.names	copykat.pred
AAACAAGTATCTCCCA-1	diploid
AAACACCAATAACTGC-1	diploid
AAACAGAGCGACTCCT-1	aneuploid
AAACAGCTTTCAGAAG-1	diploid
AAACAGTGTTCCTGGG-1	diploid
AAACCCGAACGAAATC-1	diploid
AAACCGGGTAGGTACC-1	aneuploid
AAACCGTTCGTCCAGG-1	diploid
AAACCTAAGCAGCCGG-1	diploid
AAACCTCATGAAGTTG-1	aneuploid
AAACGAGACGGTTGAT-1	aneuploid
AAACGGGCGTACGGGT-1	diploid
AAACGGTTGCGAACTG-1	diploid
AAACTCGTGATATAAG-1	diploid
AAACTGCTGGCTCCAA-1	aneuploid
AAACTTAATTGCACGC-1	diploid
AAACTTGCAAACGTAT-1	diploid
AAAGAATGACCTTAGA-1	diploid
AAAGACTGGGCGCTTT-1	aneuploid
AAAGCTTGCCTACATA-1	diploid
AAAGGCCCTATAATAC-1	diploid
AAAGGGATGTAGCAAG-1	aneuploid
AAAGGGCAGCTTGAAT-1	aneuploid
AAAGTAGCATTGCTCA-1	diploid
AAAGTCACTGATGTAA-1	aneuploid
AAAGTCGACCCTCAGT-1	aneuploid
AAAGTGTGATTTATCT-1	aneuploid
AAAGTTGACTCCCGTA-1	aneuploid
AAATAACCATACGGGA-1	aneuploid
AAATAAGGTAGTGCCC-1	diploid
AAATACCTATAAGCAT-1	aneuploid
AAATAGCTTAGACTTT-1	aneuploid
AAATAGGGTGCTATTG-1	diploid
AAATCGCGGAAGGAGT-1	diploid
AAATCGTGTACCACAA-1	aneuploid
AAATCTAGCCCTGCTA-1	diploid
AAATGATTCGATCAGC-1	diploid
AAATGCTCGTTACGTT-1	aneuploid
AAATGGTCAATGTGCC-1	aneuploid
AAATGTATCTTATCCC-1	aneuploid
AAATTAACGGGTAGCT-1	aneuploid
AAATTAATAAGCGCGA-1	aneuploid
AAATTACACGACTCTG-1	aneuploid
AAATTACCTATCGATG-1	aneuploid
AAATTCCAGGTCCAAA-1	diploid
AAATTGATAGTCCTTT-1	diploid
AAATTGCGGCGGTTCT-1	aneuploid
AAATTTGCGGGTGTGG-1	aneuploid
AACAACTGGTAGTTGC-1	aneuploid
AACAATACATTGTCGA-1	diploid
AACAATTACTCTACGC-1	aneuploid
AACACACGCTCGCCGC-1	diploid
AACACGAGACGCGGCC-1	diploid
AACAGCTGTGTGGCAA-1	diploid
AACAGGAAATCGAATA-1	diploid
AACAGGATGGGCCGCG-1	aneuploid
AACAGGTAGTATGGAT-1	diploid
AACATATCAACTGGTG-1	aneuploid
AACATCGATACGTCTA-1	diploid
AACATTGTGACTCGAG-1	diploid
AACCAAGACTTCTCTG-1	aneuploid
AACCATAGGGTTGAAC-1	diploid
AACCATGGGATCGCTA-1	aneuploid
AACCCAGAGACGGAGA-1	aneuploid
AACCCATCCCATGATC-1	diploid
AACCCGACAACCCGTG-1	diploid
AACCCTACTGTCAATA-1	aneuploid
AACCGAGCTTGGTCAT-1	aneuploid
AACCGCTAAGGGATGC-1	aneuploid
AACCTCGCTTTAGCCC-1	diploid
AACCTTTAAATACGGT-1	diploid
AACCTTTACGACGTCT-1	aneuploid
AACGATAATGCCGTAG-1	aneuploid
AACGATAGAAGGGCCG-1	aneuploid
AACGATATGTCAACTG-1	aneuploid
AACGCATGATCTGGGT-1	aneuploid
AACGCGAACGGCAACA-1	aneuploid
AACGCTGTTGCTGAAA-1	diploid
AACGGACGTACGTATA-1	aneuploid
AACGGCCATCTCCGGT-1	aneuploid
AACGTACTGTGGGTAC-1	aneuploid
AACGTCAGACTAGTGG-1	aneuploid
AACGTGCGAAAGTCTC-1	aneuploid
AACGTTATCAGCACCT-1	aneuploid
AACTACCCGTTTGTCA-1	diploid
AACTAGGCTTGGGTGT-1	diploid
AACTCAAGTTAATTGC-1	diploid
AACTCCAGAGCGTGTT-1	diploid
AACTCTCAATAGAGCG-1	aneuploid
AACTCTCAGTGTGCTC-1	diploid
AACTGATATTAGGCCT-1	aneuploid
AACTGGGTCCCGACGT-1	aneuploid
AACTTCTGCGTCTATC-1	aneuploid
AACTTGCCCGTATGCA-1	aneuploid
AACTTGCGTTCTCGCG-1	aneuploid
AACTTTACGGGAGCTT-1	aneuploid
AACTTTCTCGATCATG-1	diploid
AAGAAGGATCAGTTAG-1	aneuploid
AAGACCAAATAACTCA-1	diploid
AAGACCCAACTGAACA-1	diploid
AAGACTGCAAGCTACT-1	aneuploid
AAGAGATGAATCGGTA-1	aneuploid
AAGAGCTCTTTATCGG-1	aneuploid
AAGAGGATGTACGCGA-1	aneuploid
AAGAGGCATGGATCGC-1	aneuploid
AAGATGGCACCGGACC-1	diploid
AAGATTGGCGGAACGT-1	aneuploid
AAGCATACTCTCCTGA-1	aneuploid
AAGCCGAAGCGGTTTA-1	diploid
AAGCCGCCGTGAAATC-1	diploid
AAGCGCAGGGCTTTGA-1	diploid
AAGCTAGATCGAGTAA-1	diploid
AAGCTCGTGCCAAGTC-1	aneuploid
AAGGAGCGGTTGGTGC-1	aneuploid
AAGGATCGATCGCTTG-1	diploid
AAGGATGAGGGACCTC-1	aneuploid
AAGGCAGGCTGTCTCC-1	diploid
AAGGCTGTGCTCATCG-1	aneuploid
AAGGGAACGACTGGCT-1	diploid
AAGGGACAGATTCTGT-1	aneuploid
AAGGGACTATGCATTC-1	diploid
AAGGGTTTGATTTCAG-1	diploid
AAGGTATCCTAATATA-1	aneuploid
AAGGTGATAAACCAGC-1	aneuploid
AAGTAGAAGACCGGGT-1	aneuploid
AAGTAGTGACGCGAGG-1	aneuploid
AAGTCAATTGTCGTCA-1	aneuploid
AAGTCTTCTGTGGCCT-1	aneuploid
AAGTGACGACCGAATT-1	aneuploid
AAGTGAGTCGGGTTTA-1	diploid
AAGTGCAAAGGTAGAC-1	aneuploid
AAGTGCCTTGACTGTA-1	diploid
AAGTGCGTTAGAATCT-1	diploid
AAGTGCTTCTCTATTG-1	diploid
AAGTGTTTGGAGACGG-1	diploid
AAGTTCACTCCAAGCT-1	diploid
AAGTTCAGTCTGCGTA-1	aneuploid
AAGTTCGGCCAACAGG-1	diploid
AATAACAACGCTCGGC-1	aneuploid
AATAACACTAGAACAA-1	diploid
AATAATCTTCGTATCG-1	diploid
AATACAATGTTTCAGG-1	aneuploid
AATAGAACAGAGTGGC-1	diploid
AATAGAATCTGTTTCA-1	aneuploid
AATAGTCGCGAGTCGG-1	aneuploid
AATATCGAATCAATGC-1	diploid
AATATCGAGGGTTCTC-1	aneuploid
AATATTGGAGTATTGA-1	aneuploid
AATCAGACTGCAGGAC-1	aneuploid
AATCAGGTTTCATTTA-1	diploid
AATCATGTAAAGACTC-1	diploid
AATCCAAGGGCCTGAG-1	aneuploid
AATCCATGCAAGGGTG-1	aneuploid
AATCGCCTCAGCGCCA-1	aneuploid
AATCGCGCAGAGGACT-1	diploid
AATCGTGAGCCGAGCA-1	diploid
AATCTAGGTTTACTTG-1	diploid
AATCTATGCCGGAGCC-1	aneuploid
AATCTCTACTGTGGTT-1	aneuploid
AATCTGCGTTGGGACG-1	aneuploid
AATCTGGCTTTCTAGT-1	diploid
AATGACAGCAATGTCT-1	diploid
AATGACGTAGGATGTC-1	aneuploid
AATGACTGTCAGCCGG-1	aneuploid
AATGAGTTCGCATATG-1	aneuploid
AATGATGATACGCTAT-1	aneuploid
AATGATGCGACTCCTG-1	aneuploid
AATGCAACCGGGTACC-1	aneuploid
AATGCACCAAGCAATG-1	aneuploid
AATGGTCCACCGTTCA-1	aneuploid
AATGGTTCTCACAAGC-1	aneuploid
AATGTATGGCACTGTA-1	diploid
AATGTGCCCGAGGTGT-1	diploid
AATTAAAGGTCGGCGT-1	aneuploid
AATTAACGGATTTCCA-1	diploid
AATTACGAGACCCATC-1	diploid
AATTACTCGTACGCTC-1	aneuploid
AATTAGCGCTGCAGCG-1	aneuploid
AATTCATAAGGGATCT-1	aneuploid
AATTCCAAGCATGTAC-1	diploid
AATTCGATTCGAGGAT-1	diploid
AATTCTAGAGTTAGGC-1	aneuploid
AATTGAACGCTCTGGT-1	aneuploid
AATTGCGTGGATTACA-1	diploid
ACAAAGAAGGTAGGCC-1	diploid
ACAAATCGCACCGAAT-1	aneuploid
ACAAATGGTAGTGTTT-1	aneuploid
ACAACAGCATGAGCTA-1	aneuploid
ACAACGGTCCCTGCGA-1	aneuploid
ACAAGCAGTGCCTAGC-1	aneuploid
ACAAGCTATATGGAAG-1	aneuploid
ACAAGGAAATCCGCCC-1	aneuploid
ACAAGGACAAGAGGTT-1	aneuploid
ACAAGGGCAGGCTCTG-1	aneuploid
ACAATAGTCGTACGTT-1	diploid
ACAATCCATTTAAACC-1	aneuploid
ACAATGAATACGGAGA-1	diploid
ACAATTGTGTCTCTTT-1	diploid
ACAATTTAGGAGGCTC-1	aneuploid
ACAATTTGAGCAGTGG-1	aneuploid
ACACACCAGGACCAGT-1	aneuploid
ACACACTTTCTACACG-1	aneuploid
ACACATGATCAAATCT-1	diploid
ACACATTGACGCAACA-1	aneuploid
ACACCACATAATTAGC-1	diploid
ACACCCAGCATGCAGC-1	aneuploid
ACACCCGAGAAATCCG-1	aneuploid
ACACCGAGCGCTCTTT-1	aneuploid
ACACCGGTCTGACCGC-1	diploid
ACACCTTACTACTTGC-1	diploid
ACACGAGACTCCTTCT-1	aneuploid
ACACGTAGGCCACAAG-1	diploid
ACACTGATCAAGGTGT-1	diploid
ACAGAACTGAGAACAA-1	diploid
ACAGCGACATTCTCAT-1	diploid
ACAGGCACGGATCCTT-1	diploid
ACAGGCTTGCCCGACT-1	diploid
ACAGGTGGAGGTGAGG-1	diploid
ACAGGTGTGTTGTTGC-1	aneuploid
ACAGTAATACAACTTG-1	diploid
ACATAATAAGGCGGTG-1	aneuploid
ACATCAGCTGGGACGC-1	aneuploid
ACATCCTGGTAACTGT-1	aneuploid
ACATCGATCGTTTACC-1	aneuploid
ACATCGGTCAGCCGCG-1	aneuploid
ACATCGTATGCAATGG-1	aneuploid
ACATGGCGCCAAAGTA-1	diploid
ACATGGCTCAATTTAG-1	aneuploid
ACATTAGTTTATATCC-1	aneuploid
ACATTCGCGCGGAATA-1	diploid
ACCAACACCACACACT-1	diploid
ACCAACCGCACTCCAC-1	diploid
ACCAAGAACGCGTGTC-1	aneuploid
ACCAATATGCAAGTTA-1	diploid
ACCACAAGTTTCTATC-1	aneuploid
ACCACCAATGTAACAA-1	diploid
ACCACGTGCAGCTATA-1	aneuploid
ACCACTGTTCAAGAAG-1	aneuploid
ACCAGTGCGGGAGACG-1	aneuploid
ACCATATCCGCAATAA-1	aneuploid
ACCATCCGCCAACTAG-1	diploid
ACCATCGTATATGGTA-1	aneuploid
ACCATTAAGGGTGTCA-1	aneuploid
ACCCAACGCCCGTGGC-1	aneuploid
ACCCACCTACATGCTC-1	aneuploid
ACCCATCTTGAGGGTA-1	aneuploid
ACCCGAGCGAAATTAC-1	diploid
ACCCGATTGGTTCCGA-1	diploid
ACCCGGAAACTCCCAG-1	diploid
ACCCGGAGCACCACAA-1	diploid
ACCCGGATGACGCATC-1	aneuploid
ACCCGGTTACACTTCC-1	aneuploid
ACCCGTAGCAGAGAAT-1	diploid
ACCCGTGTCATCAGTA-1	diploid
ACCCTATAGGACTGAG-1	aneuploid
ACCCTATGCCATATCG-1	diploid
ACCCTCCCGTCAGGGC-1	diploid
ACCCTCCCTTGCTATT-1	aneuploid
ACCCTTCATCTGCGAA-1	aneuploid
ACCGAAGAGTCTGGTT-1	diploid
ACCGACTGAGTCCCAC-1	aneuploid
ACCGAGTCTCCTTATT-1	diploid
ACCGATGGTAGCATCG-1	aneuploid
ACCGCAATAACTGCCT-1	aneuploid
ACCGCGGTGGAAGTCG-1	diploid
ACCGGGCCTTTGTTGA-1	aneuploid
ACCGGTCAGGTACACC-1	diploid
ACCGTCCACTGGGCCC-1	diploid
ACCGTGACCACGTGGG-1	diploid
ACCTAAGTACCTTTCA-1	diploid
ACCTAATCGACTTCCT-1	aneuploid
ACCTACAGTATGTGGT-1	diploid
ACCTACTATAAATCTA-1	diploid
ACCTCCGTTATTCACC-1	aneuploid
ACCTGCGTGTCATGTT-1	diploid
ACGAAATGGGCGGCAC-1	aneuploid
ACGACCCATGAGTTGC-1	diploid
ACGAGAACCCATCACG-1	aneuploid
ACGAGGATACCACTCT-1	diploid
ACGAGTACGGATGCCC-1	aneuploid
ACGATACATAGAACTA-1	aneuploid
ACGATACCTATCCTGA-1	aneuploid
ACGATCATCTTGTAAA-1	aneuploid
ACGATGCATATGTTAT-1	aneuploid
ACGCAAACTAATAGAT-1	diploid
ACGCAATCACTACAGC-1	aneuploid
ACGCATTCGTGAGTAC-1	aneuploid
ACGCCAGATGATTTCT-1	aneuploid
ACGCCGCTAGACGACC-1	aneuploid
ACGCGAAGTCAGACGA-1	aneuploid
ACGCGCTACACAGGGT-1	aneuploid
ACGCGGGCCAAGGACA-1	aneuploid
ACGCGTTTCTTAAGAG-1	aneuploid
ACGCTAGTGATACACT-1	aneuploid
ACGCTGTGAGGCGTAG-1	aneuploid
ACGGAATTTAGCAAAT-1	aneuploid
ACGGACGCAGCGACAA-1	diploid
ACGGACTCTCAAAGCG-1	diploid
ACGGAGCGCAAATTAC-1	diploid
ACGGCACTTGCTTGGG-1	aneuploid
ACGGCCAACATGGACT-1	diploid
ACGGCGACGATGGGAA-1	aneuploid
ACGGCTGGATGTAGAA-1	diploid
ACGGGAGTGTCGGCCC-1	diploid
ACGGGCGTATGCGACA-1	diploid
ACGGGTCATGTGACTT-1	aneuploid
ACGGTCACCGAGAACA-1	diploid
ACGTAGATTGCTGATG-1	aneuploid
ACGTAGGAGAGTCGCT-1	diploid
ACGTATTACTCCGATC-1	aneuploid
ACGTCTCGTTCCGGGA-1	diploid
ACGTGACAAAGTAAGT-1	diploid
ACGTGCGCCTCGTGCA-1	aneuploid
ACGTTAATGTCGAAGA-1	aneuploid
ACGTTAGATTTGCCCG-1	aneuploid
ACGTTATTGGTCACTC-1	aneuploid
ACGTTCACTATGCCGC-1	diploid
ACGTTCGCAATCAATT-1	diploid
ACGTTCGTTCAGGAAA-1	diploid
ACGTTTAGTTGTGATC-1	aneuploid
ACTACAAAGAGAGGTG-1	diploid
ACTACATCCCGACAAG-1	diploid
ACTACCATCCGAGGGC-1	diploid
ACTACGCGTTAGAATT-1	diploid
ACTAGTTGCGATCGTC-1	diploid
ACTATCCAGGGCATGG-1	aneuploid
ACTATCGCCGGCTAAA-1	aneuploid
ACTATGTCCAGCTGCC-1	diploid
ACTATTTCCGGGCCCA-1	diploid
ACTCAACGAATGTATT-1	aneuploid
ACTCAAGTGCAAGGCT-1	diploid
ACTCAATAAAGGCACG-1	aneuploid
ACTCATGGCAGCCTTC-1	diploid
ACTCCCATTCCTAAAG-1	diploid
ACTCCCGAATTCGTTT-1	aneuploid
ACTCCCTAGAATAGTA-1	aneuploid
ACTCCGGCCGACCACT-1	diploid
ACTCGATGTATTTCAT-1	aneuploid
ACTCGTCAGTAATCCC-1	aneuploid
ACTCTAAACCTGGGAT-1	aneuploid
ACTCTCTGACTTAGGT-1	aneuploid
ACTCTGACCTAATAGA-1	diploid
ACTCTTGTATAGTAAC-1	aneuploid
ACTGAAACGCCGTTAG-1	diploid
ACTGAATGGCGAAAGT-1	aneuploid
ACTGCCGTCGTAACTC-1	aneuploid
ACTGCTCGGAAGGATG-1	diploid
ACTGGGATGCCAGTGC-1	diploid
ACTGTACGATACACAT-1	aneuploid
ACTGTAGCACTTTGGA-1	aneuploid
ACTGTCCAGGATTATA-1	aneuploid
ACTGTCTTCTTTAGAA-1	aneuploid
ACTGTGCTAGTAGATC-1	aneuploid
ACTTACGCATCCACGC-1	diploid
ACTTAGTACGACAAGA-1	aneuploid
ACTTATACTTACCCGG-1	aneuploid
ACTTATTAGGATCGGT-1	aneuploid
ACTTATTTATGTGCCA-1	aneuploid
ACTTCAGGCTGATCCC-1	diploid
ACTTCCAGTGGAAGCT-1	diploid
ACTTCCATGCGGGACA-1	diploid
ACTTCGCCATACGCAC-1	aneuploid
ACTTGACTCCCTCTTT-1	aneuploid
ACTTGCTCTATCTACC-1	diploid
ACTTGGGACCCGGTGG-1	aneuploid
ACTTGTAGTCCCTTCA-1	diploid
ACTTTACCCTCATGAA-1	aneuploid
ACTTTATACACCACTT-1	diploid
ACTTTGACTGCATCCT-1	aneuploid
ACTTTGGTCGTGCTCC-1	diploid
ACTTTGTCGACGCACT-1	aneuploid
AGAACCCAGCGTGACA-1	diploid
AGAACCCTCAATTGGG-1	diploid
AGAACGTGGTACATTC-1	aneuploid
AGAAGGTACACTTCAC-1	diploid
AGAAGGTTGCCGAATT-1	aneuploid
AGAATAAATCTTCAGG-1	aneuploid
AGAATTATGGATTCGA-1	aneuploid
AGAATTGTTTGACATA-1	aneuploid
AGACAGCTCAGAATCC-1	diploid
AGACAGGCATCTCAGC-1	diploid
AGACCATGGGATACAA-1	aneuploid
AGACCCACCGCTGATC-1	aneuploid
AGACCGCTCCGCGGTT-1	diploid
AGACCGGGAAACCCTG-1	aneuploid
AGACGAAGTGCCGGTC-1	diploid
AGACGACGATGCCGCT-1	diploid
AGACTAGCCTTCCAGA-1	aneuploid
AGACTGTTACCGGGTC-1	diploid
AGAGAACCGTCTAGGA-1	aneuploid
AGAGATCTCTAAAGCG-1	aneuploid
AGAGCGGGCTAATCAT-1	aneuploid
AGAGCGTACAAGCTCG-1	aneuploid
AGAGCTACGAAAGCAT-1	aneuploid
AGAGGCTTCGGAAACC-1	diploid
AGAGTAAACTTCACTA-1	diploid
AGATAACTTCAGGGCC-1	diploid
AGATACCGGTGTTCAC-1	aneuploid
AGATACGACTTCATAT-1	aneuploid
AGATACTCAAGATCGA-1	aneuploid
AGATCGTGCATAAGAT-1	aneuploid
AGATCTCAGGTGTGAT-1	aneuploid
AGATGACTCGCCCACG-1	aneuploid
AGATGAGGGTTGCGAT-1	aneuploid
AGATGATGGAGTCTGG-1	diploid
AGATGCAAGACGTGCA-1	diploid
AGATGCATCCTGTGTC-1	diploid
AGATGCTATAACGAGC-1	aneuploid
AGATTATAGGACGTTT-1	aneuploid
AGATTCACAACCGATA-1	diploid
AGCAAAGGCCGCTAGT-1	diploid
AGCAACATATCTTATT-1	aneuploid
AGCAACCGAAAGTAAT-1	diploid
AGCACACGTTTAGACT-1	diploid
AGCACTACCGGCCTGT-1	aneuploid
AGCACTACCTCACCAG-1	diploid
AGCACTTAAGGACGCC-1	aneuploid
AGCAGCCAGATGAATA-1	diploid
AGCATATCAATATGCT-1	diploid
AGCATCATTTCGAAAG-1	diploid
AGCATCGTCGATAATT-1	aneuploid
AGCATTACGAGGCAAG-1	diploid
AGCCAAGCTTTGTGTC-1	diploid
AGCCACAGGTTACCCG-1	diploid
AGCCACTCCCGTGCTT-1	aneuploid
AGCCATATAGTATGTG-1	diploid
AGCCCATACATGTAAG-1	aneuploid
AGCCCGGCATTAGAGG-1	aneuploid
AGCCCGGTAGCCTGTA-1	diploid
AGCCCTAAGCGAAGTT-1	aneuploid
AGCCCTTCTAATCCGA-1	aneuploid
AGCCCTTGGACATCCC-1	diploid
AGCCGCAAATTCAAAT-1	aneuploid
AGCCGCTTGATTAGCG-1	aneuploid
AGCCGTGGCTAAATGT-1	diploid
AGCCTTAAAGCGGAAG-1	aneuploid
AGCGACAGGAACGGTC-1	diploid
AGCGACATCCCATTCA-1	aneuploid
AGCGCATAATGAATCG-1	diploid
AGCGCGGGTGCCAATG-1	aneuploid
AGCGCTAGAGCGATGT-1	diploid
AGCGGACACTTCGTAG-1	diploid
AGCGGCGGTTAGCGGT-1	diploid
AGCGGGAAGGGTCCAT-1	aneuploid
AGCGTACGAGAGCTAG-1	aneuploid
AGCGTGGTATTCTACT-1	aneuploid
AGCTAAGTACGCAGGC-1	diploid
AGCTAGAAGCAGAAGT-1	aneuploid
AGCTATTTAATCCAAC-1	aneuploid
AGCTCCTTCGCACATC-1	diploid
AGCTCTAGACGTTCCA-1	aneuploid
AGCTCTTCCCAGTGCA-1	aneuploid
AGCTCTTCGTAACCTT-1	diploid
AGCTCTTTACTCAGTT-1	aneuploid
AGCTGAAGTAAACCAA-1	aneuploid
AGCTGTAACCTCAATC-1	diploid
AGCTTGATCAGGGTAG-1	diploid
AGCTTGATCTTAACTT-1	aneuploid
AGGAAAGCCTCTGATG-1	aneuploid
AGGACAGTCGAATCCC-1	aneuploid
AGGACGACCCATTAGA-1	aneuploid
AGGACGCTCGATGTTG-1	aneuploid
AGGACTTATAGGAGAA-1	aneuploid
AGGAGGCCTTCGCGCG-1	diploid
AGGATAAAGTCGGGAT-1	diploid
AGGATATAGGGATTTA-1	aneuploid
AGGATCACGCGATCTG-1	diploid
AGGATTGCTTACGACA-1	diploid
AGGCAGATGCGTAAAC-1	aneuploid
AGGCAGGGAGCGTACT-1	diploid
AGGCATTGTCGTAGGG-1	diploid
AGGCCACCCGTTATGA-1	aneuploid
AGGCCCAGTGACTGGT-1	aneuploid
AGGCCCTAGAACGCCA-1	aneuploid
AGGCCTATCATACCAA-1	diploid
AGGCGTCTATGGACGG-1	diploid
AGGCTATGGTTAGCTT-1	aneuploid
AGGCTTCCCGAAGAAG-1	diploid
AGGCTTGCTAGACACC-1	diploid
AGGGACCGGCTGCGTT-1	diploid
AGGGAGACATACTTCG-1	diploid
AGGGCGAGCAGCTGAT-1	diploid
AGGGCGTGATCGGCTA-1	aneuploid
AGGGCTGCAGTTACAG-1	aneuploid
AGGGTCAGAGCACTCG-1	diploid
AGGGTCGATGCGAACT-1	aneuploid
AGGGTGCTCTCGAGGG-1	aneuploid
AGGGTGGATAGTGCAT-1	aneuploid
AGGGTTCAGACGGTCC-1	diploid
AGGGTTCCCTTTGGTT-1	aneuploid
AGGGTTTAGTTCGGGA-1	aneuploid
AGGTAACCTCCTATTC-1	aneuploid
AGGTAGGTACAAAGCT-1	aneuploid
AGGTATAATTGATAGT-1	aneuploid
AGGTCGCGGAGTTACT-1	aneuploid
AGGTGTATCGCCATGA-1	aneuploid
AGGTTACACCATGCCG-1	diploid
AGGTTCTCCTTTCCGG-1	diploid
AGGTTGAGGCACGCTT-1	aneuploid
AGGTTTCACACACCTT-1	aneuploid
AGTAATGTCTTGCCGC-1	aneuploid
AGTAATTTGCAAGCGT-1	diploid
AGTACAGAAGCTTATA-1	diploid
AGTACATCATTTATCA-1	aneuploid
AGTACGGCCCGTATCG-1	aneuploid
AGTACGGGCACCTGGC-1	aneuploid
AGTACTCTTATGCCCA-1	diploid
AGTAGAAGGCGCCTCA-1	diploid
AGTAGGTAACATACAT-1	aneuploid
AGTATAATACTAGGCA-1	aneuploid
AGTATACACAGCGACA-1	diploid
AGTATCCATAATAACG-1	aneuploid
AGTCAACACCACCATC-1	aneuploid
AGTCAAGATGACACTT-1	aneuploid
AGTCACTCCGCCTCAT-1	aneuploid
AGTCAGCCACCGCCTG-1	aneuploid
AGTCCAGCGGGTACGT-1	aneuploid
AGTCCATTGGCTGATG-1	aneuploid
AGTCCCGCCTTTAATT-1	aneuploid
AGTCGACGGTCTCAAG-1	aneuploid
AGTCGGCTCAACTTTA-1	diploid
AGTCGGTTGCGTGAGA-1	diploid
AGTCGTATAAAGCAGA-1	diploid
AGTCTAAAGTATACTC-1	aneuploid
AGTCTCACAAGACTAC-1	diploid
AGTCTGGACATCCTTG-1	aneuploid
AGTGAACAAACTTCTC-1	aneuploid
AGTGACCTACTTTACG-1	aneuploid
AGTGAGACTTCCAGTA-1	aneuploid
AGTGAGCCTCGCCGCC-1	aneuploid
AGTGATATGAGTAGTT-1	aneuploid
AGTGATTCAAGCAGGA-1	aneuploid
AGTGCACGCTTAAGAA-1	diploid
AGTGCGTAGCTCGTAA-1	aneuploid
AGTGCTAAACACAGCA-1	diploid
AGTGCTTGCACGAATA-1	aneuploid
AGTGGCGGCAATTTGA-1	aneuploid
AGTGGCGTCTGAAGGT-1	diploid
AGTGGCTCCGTCGGCC-1	aneuploid
AGTGGTGTTACCCGTG-1	diploid
AGTGGTTGCGTATAGG-1	aneuploid
AGTGTATTGCGCATTG-1	aneuploid
AGTGTGCTAAGATCGC-1	aneuploid
AGTGTGGTCTATTGTG-1	aneuploid
AGTTAAACACTTGCGA-1	aneuploid
AGTTAAGTCAACCGCT-1	diploid
AGTTACCCTTAAGACT-1	aneuploid
AGTTACTCTATCGTGG-1	aneuploid
AGTTCCTACAGAATTA-1	diploid
AGTTCTGCGTTGTATC-1	aneuploid
AGTTGACATCGGCTGG-1	aneuploid
AGTTGACGGTCCTTGC-1	diploid
AGTTGCGGTCCTCAAC-1	diploid
AGTTGCTGACTGATAT-1	aneuploid
AGTTTATGTAAAGACA-1	diploid
AGTTTCGCAGGTCGGA-1	aneuploid
AGTTTGCACCTGCCTC-1	diploid
AGTTTGGCACGGGTTG-1	diploid
AGTTTGGCCAGACCTA-1	diploid
ATAAACGGACCCGTAA-1	aneuploid
ATAAAGGCTCGGTCGT-1	aneuploid
ATAAATATTAGCAGCT-1	aneuploid
ATAACGCCGGAGGGTC-1	aneuploid
ATAACGGAGTCCAACG-1	aneuploid
ATAAGGTGGAGAACAT-1	aneuploid
ATAAGTAGGATTCAGA-1	aneuploid
ATAAGTAGGGCGACTC-1	aneuploid
ATAAGTTACCGCGACG-1	aneuploid
ATAATACCGTTAGCCG-1	aneuploid
ATAATAGCTGTTGAAT-1	aneuploid
ATAATAGTGTAGGGAC-1	aneuploid
ATAATCTTGGAGAACC-1	diploid
ATACAGGCCCTCCAAT-1	diploid
ATACCACGGGCAACTT-1	aneuploid
ATACCTAACCAAGAAA-1	diploid
ATACGCCGGCGAAACC-1	aneuploid
ATACGGAACGTCGTTT-1	diploid
ATACGGGTTTCGATTG-1	aneuploid
ATACGGTGAAGATGCA-1	aneuploid
ATACGTACTTAGCCAC-1	diploid
ATACGTCCACTCCTGT-1	aneuploid
ATACGTTATGCACGGA-1	aneuploid
ATACTAGCATGACCCT-1	aneuploid
ATACTCTCGCCACTCT-1	aneuploid
ATACTGCCTTACACCG-1	diploid
ATACTTGTTCTCGAGC-1	aneuploid
ATAGACAACGGGACCT-1	aneuploid
ATAGACGAAGAGAAAG-1	aneuploid
ATAGAGTACTGGGACA-1	aneuploid
ATAGAGTTATCAACTT-1	aneuploid
ATAGCAACTAGGGAAG-1	diploid
ATAGCCTCAGTACCCA-1	aneuploid
ATAGCTGCTCTTGTTA-1	aneuploid
ATAGGCGGCTATAGAA-1	aneuploid
ATAGGCTAGCTTCGCA-1	aneuploid
ATAGGGATATCCTTGA-1	aneuploid
ATAGGTTGGGCAGATG-1	aneuploid
ATAGTGAAGCGTTCTC-1	aneuploid
ATAGTTCCACCCACTC-1	aneuploid
ATATAAAGCGCTCGTG-1	diploid
ATATAAATGTAGCTGC-1	diploid
ATATACATGTATGGTA-1	diploid
ATATCAACCTACAGAG-1	aneuploid
ATATCGGTAGGGAGAT-1	diploid
ATATCGTTCCTCGAAC-1	diploid
ATATCTCCCTCGTTAA-1	aneuploid
ATATGGGATAGCAACT-1	diploid
ATATGTCTCCCTAGCC-1	aneuploid
ATATTATCCCGTATTT-1	aneuploid
ATATTCAGTTAAACCT-1	aneuploid
ATATTCCACATAGTGA-1	diploid
ATATTCCCACAGGTCA-1	aneuploid
ATATTGCTGTCAAAGT-1	aneuploid
ATATTTAACCCTCAAG-1	aneuploid
ATCAAACACTGTTCCA-1	diploid
ATCAAACGAAGGTTTG-1	diploid
ATCAAGATCCCAGGAC-1	diploid
ATCAATCTGGGCTGCA-1	aneuploid
ATCAATGCCGTGGCTG-1	diploid
ATCACATTAGAATATC-1	aneuploid
ATCACGTGCTAATTAA-1	diploid
ATCACTTCATCCTCGC-1	aneuploid
ATCAGACGGCACGCCG-1	aneuploid
ATCAGCCTCATGCTGC-1	diploid
ATCAGCTCGTCCACTA-1	diploid
ATCAGGTAGCTGACAG-1	diploid
ATCAGTAGGCAGGGAT-1	aneuploid
ATCATAGATCGACGAG-1	diploid
ATCATCCAATATTTGT-1	aneuploid
ATCATGGACTACCGAC-1	diploid
ATCCAACGCAGTCATA-1	aneuploid
ATCCAATGGAGGGTCC-1	aneuploid
ATCCAATGGTACCGAA-1	aneuploid
ATCCAGAGCAACAACC-1	aneuploid
ATCCAGGATTCGTGAA-1	aneuploid
ATCCCATTTCCGTGGG-1	diploid
ATCCTACCTAAGCTCT-1	aneuploid
ATCCTGAATCGCTGCG-1	aneuploid
ATCCTGCGTGGAATGG-1	aneuploid
ATCCTTCTGAAAGAAC-1	diploid
ATCGACCCAATACAGA-1	aneuploid
ATCGACTCTTTCCGTT-1	aneuploid
ATCGCACGATTGTTCA-1	aneuploid
ATCGCCAGTCAACATT-1	diploid
ATCGCTGCGTGCAGCA-1	diploid
ATCGGAGACAGACGGC-1	diploid
ATCGGCAAGCAGTCCA-1	aneuploid
ATCGGTTACCTAGTAA-1	aneuploid
ATCGTATTCCGAGAAC-1	aneuploid
ATCGTCCAATCGAGTC-1	aneuploid
ATCGTGGAAAGTCTGG-1	diploid
ATCGTTAGCTAGCGGA-1	diploid
ATCTAACGTCCCTATG-1	aneuploid
ATCTAATATCCTACGG-1	diploid
ATCTACCATCTGCTCC-1	diploid
ATCTCCCTGCAATCTA-1	aneuploid
ATCTCGTGAGCGAAAC-1	diploid
ATCTGACATGGAAGGA-1	diploid
ATCTGATAGTGTCTTA-1	aneuploid
ATCTGCACCTCTGCGA-1	aneuploid
ATCTGCTGTTATCGCC-1	diploid
ATCTGGGCTGTTCTTG-1	diploid
ATCTGGTTAAGACTGT-1	aneuploid
ATCTGTAATTGTACCC-1	aneuploid
ATCTTAGGGCATTAAT-1	diploid
ATCTTGACTTGTCCAA-1	aneuploid
ATCTTTCGTATAACCA-1	diploid
ATGAAGCCAAGGAGCC-1	aneuploid
ATGAAGTGGACCCAGC-1	aneuploid
ATGACGCCGGCTCTAA-1	aneuploid
ATGACGCGTTCTATCC-1	diploid
ATGACTATCAGCTGTG-1	diploid
ATGACTATGCGACATT-1	aneuploid
ATGAGGGCAGCGGCTA-1	diploid
ATGATCGGGAATAGAC-1	aneuploid
ATGATGCAATGGTACA-1	aneuploid
ATGCACCTTCCTTAAT-1	aneuploid
ATGCACGCGCTGTTCA-1	diploid
ATGCCATTTGCGACCA-1	aneuploid
ATGCCGGTCTTGCATA-1	aneuploid
ATGCCGGTTGATGGGA-1	aneuploid
ATGCGACAGTCCCATT-1	aneuploid
ATGCGAGTCCCACCAC-1	diploid
ATGCTCTGGCGCGGTA-1	diploid
ATGGAAATTTAAGGAG-1	diploid
ATGGAGCAGGCCGTGA-1	aneuploid
ATGGATCCGGCGTCCG-1	aneuploid
ATGGCAGCATTACGAT-1	diploid
ATGGCAGCCGAGAAAC-1	aneuploid
ATGGCGGAATAGTCGC-1	diploid
ATGGGACCTGCTGAAC-1	diploid
ATGGGCCTCGGCCTCT-1	aneuploid
ATGGGTGTATACCTCC-1	diploid
ATGGTCGCGTGGTTTC-1	aneuploid
ATGTAAGGCTGCTCTT-1	aneuploid
ATGTCATTTCCCATTG-1	aneuploid
ATGTCTTGTTTGACTC-1	diploid
ATGTGAAAGCCTAATG-1	diploid
ATGTGCATCCGACGCA-1	aneuploid
ATGTGGACATCTTGAT-1	aneuploid
ATGTTACGAGCAATAC-1	aneuploid
ATGTTCCTGCCCACCT-1	aneuploid
ATGTTCGTCGACCCAC-1	aneuploid
ATGTTTCGGCCCGGAG-1	diploid
ATTAAACATGCGGACC-1	aneuploid
ATTAACACCTGAGATA-1	aneuploid
ATTAATACTACGCGGG-1	aneuploid
ATTAATGAACCAGTCG-1	aneuploid
ATTACATGTCAGTCTT-1	diploid
ATTACCACACTGCCTG-1	diploid
ATTACGCGCTGGCAGG-1	aneuploid
ATTACGGGCTACGGTT-1	diploid
ATTACTAGCCTCTTGC-1	aneuploid
ATTACTTACTGGGCAT-1	aneuploid
ATTAGATTCCTCAGCA-1	aneuploid
ATTAGATTGATAGCGG-1	aneuploid
ATTAGGCGATGCTTTC-1	aneuploid
ATTATACTTTGCTCGT-1	aneuploid
ATTATAGCTACTTTAC-1	diploid
ATTATCGGAATGTACG-1	diploid
ATTATGCCATAGGGAG-1	aneuploid
ATTCAAAGTACCTGTT-1	aneuploid
ATTCAACCATTTAAGG-1	diploid
ATTCACTGATGTTGGA-1	diploid
ATTCAGGACCTATTTC-1	aneuploid
ATTCAGTAGCAGGGTC-1	aneuploid
ATTCATATACTGTCCA-1	aneuploid
ATTCATCGTTGAGGCA-1	diploid
ATTCCCACATAAACAA-1	aneuploid
ATTCCCGAAGGTACAG-1	diploid
ATTCCTCCGCCAGTGC-1	aneuploid
ATTCGACGCCGGGCCT-1	aneuploid
ATTCGTGCTATCTCTT-1	diploid
ATTCTCGTCTCTTTAG-1	aneuploid
ATTGATAGCAACGAGA-1	aneuploid
ATTGATCACCACATTT-1	diploid
ATTGATGAGTCCTAAC-1	aneuploid
ATTGCCTTTATGTTTG-1	diploid
ATTGCGATCAGTAACT-1	diploid
ATTGGGAATATCTTGG-1	aneuploid
ATTGGTAGGATCCGCT-1	aneuploid
ATTGTACAACTCGGCT-1	aneuploid
ATTGTCGCAATACCTT-1	aneuploid
ATTGTCTGTTTCATGT-1	diploid
ATTTAACTCGTATTAC-1	aneuploid
ATTTACAGTTTACTGG-1	aneuploid
ATTTACTAAGTCCATT-1	aneuploid
ATTTCCGGGTTCTGCG-1	diploid
ATTTGCGCGAGTAGCT-1	diploid
ATTTGGAGATTGCGGT-1	diploid
ATTTGTCTTGGGAGCT-1	aneuploid
ATTTGTTCCAGGGCTC-1	aneuploid
CAAACCAGGTCTGCAT-1	aneuploid
CAAACCCTCCGGCGGG-1	diploid
CAAACGAGTATCGCAG-1	aneuploid
CAAACGGTCGCACTTT-1	aneuploid
CAAAGATTATTGGGCC-1	diploid
CAAAGGTCATCTGAAA-1	diploid
CAAAGTCAGGTTAGCT-1	aneuploid
CAAATCTCTCACAAGG-1	aneuploid
CAAATGTCCTTCCGTG-1	aneuploid
CAAATTGTCAGCAAGC-1	aneuploid
CAACACATCTCCTGCC-1	aneuploid
CAACATGGCCTGATAA-1	aneuploid
CAACCTACCGAGCAGT-1	diploid
CAACGACCCGTTTACA-1	aneuploid
CAACGCGATGAGCCAA-1	diploid
CAACGGTTCTTGATAC-1	aneuploid
CAACGTGGTGGAGTCT-1	diploid
CAACTATATCGAATGC-1	aneuploid
CAACTCCTTGATCCCG-1	aneuploid
CAACTGCTCATCCGAT-1	diploid
CAACTTGTAGTGGGCA-1	aneuploid
CAAGAGGGCGGAGTAC-1	aneuploid
CAAGATATTATAACGT-1	aneuploid
CAAGCAACGTCGGAGT-1	aneuploid
CAAGCACCAAATGCCT-1	aneuploid
CAAGCGGCACATAATT-1	diploid
CAAGGATCGCATGTTC-1	aneuploid
CAAGGTCCTATAGGCT-1	aneuploid
CAAGTAAGTGATAGAC-1	diploid
CAAGTGTGGTTGCAAA-1	aneuploid
CAATAAACCTTGGCCC-1	aneuploid
CAATACGCTCTGAGGC-1	aneuploid
CAATATTCTTGACCTA-1	diploid
CAATCCTGCCGTGGAG-1	aneuploid
CAATGAGGTTCGACTA-1	diploid
CAATGGATCTCTACCA-1	aneuploid
CAATGTGCCAACCCTT-1	diploid
CAATTAAGGGTGATGA-1	aneuploid
CAATTTCGTATAAGGG-1	aneuploid
CAATTTGACCGGGAAG-1	aneuploid
CACAATGAGCTGCTAT-1	aneuploid
CACACAGCTTGCGCTC-1	diploid
CACACAGGGATAGATT-1	aneuploid
CACACGCGCTGTCTTA-1	aneuploid
CACAGCACCCACGGCA-1	aneuploid
CACAGCTAGGGAGTGA-1	aneuploid
CACAGGGCCATATAGT-1	diploid
CACAGGGCCGTTGTCA-1	aneuploid
CACATATTAGCAGGAT-1	aneuploid
CACATCGTGCACGCGC-1	diploid
CACATGATTCAGCAAC-1	aneuploid
CACATGTTTGGACATG-1	aneuploid
CACATTCTTTCGATGG-1	aneuploid
CACATTTCTTGTCAGA-1	diploid
CACCAATCATCCGTCT-1	diploid
CACCACGCCACACAGA-1	aneuploid
CACCAGTCAGCATGCA-1	diploid
CACCCAAATCTTATGT-1	aneuploid
CACCCACACGTCACCC-1	aneuploid
CACCCTAACAAGATCT-1	diploid
CACCCTTGGTGAGACC-1	diploid
CACCGCCAGAAGGTTT-1	aneuploid
CACCGCGTCCACTCTA-1	aneuploid
CACCGGTAGAGACATT-1	diploid
CACCGTATCCCATCCG-1	diploid
CACCGTTAGGGATCAC-1	diploid
CACCGTTGCGCGATAT-1	aneuploid
CACCTAATAGAGTCGT-1	aneuploid
CACCTAATCAGTTTAC-1	aneuploid
CACCTTGCGAAACTCG-1	aneuploid
CACCTTGGCGCCTTTG-1	aneuploid
CACGAAAGTTAGTCCC-1	aneuploid
CACGAGCAAACCAGAC-1	diploid
CACGCACAGCGCAGCT-1	aneuploid
CACGCAGCGAGGCTTT-1	aneuploid
CACGCGGAACTGTTGC-1	aneuploid
CACGTCAATCAATGGA-1	diploid
CACGTCGGCAACCTCT-1	aneuploid
CACGTTCGTGCTCTAG-1	aneuploid
CACGTTTCGTACACAC-1	diploid
CACTAAAGTTGCCTAT-1	aneuploid
CACTACGGGAGCTGCC-1	diploid
CACTCAAGAGCTATGG-1	aneuploid
CACTCCTATGTAAGAT-1	diploid
CACTCCTCTCGGTCGG-1	aneuploid
CACTCGAGCTGAACAA-1	aneuploid
CACTCGGTTAGGAGGA-1	aneuploid
CACTCTTCTGCTAGCC-1	diploid
CACTGTCCAAGTGAGA-1	aneuploid
CACTTAATCAGACGGA-1	aneuploid
CACTTCGCCACAGGCT-1	aneuploid
CACTTCGTCTTATCTC-1	aneuploid
CAGAACTTAGCCCTCT-1	diploid
CAGAATAACACACGGA-1	diploid
CAGACACCGATCGCTG-1	diploid
CAGACCTGTAAGTGTT-1	aneuploid
CAGACGAACCTGATAC-1	aneuploid
CAGAGACGGTCACCCA-1	diploid
CAGAGCATGAGCTTGC-1	aneuploid
CAGAGGCGATGCATGA-1	diploid
CAGATAATGGGCGGGT-1	diploid
CAGATACTAACATAGT-1	aneuploid
CAGATATGAAGATGAC-1	diploid
CAGATCATTTAAAGTC-1	aneuploid
CAGATCCTGGTTTGAA-1	diploid
CAGCAGCCCGTTCCTT-1	aneuploid
CAGCAGTCCAGACTAT-1	diploid
CAGCAGTCTGTGCTGC-1	diploid
CAGCCTCCTGCAGAGG-1	aneuploid
CAGCGATTCCCTTCAA-1	diploid
CAGCGCCAACACGATA-1	aneuploid
CAGCTCACTGAGACAT-1	diploid
CAGCTCGACAAGTTAA-1	aneuploid
CAGCTCTGGGCTCACT-1	diploid
CAGCTTAGTAGGTAGC-1	aneuploid
CAGGATATATCGTTGT-1	aneuploid
CAGGCCAGTACCACCT-1	diploid
CAGGCCGTTTGGGTGT-1	aneuploid
CAGGCGCCATGCTAGG-1	aneuploid
CAGTAACTATTTATTG-1	diploid
CAGTAATCCCTCCCAG-1	aneuploid
CAGTACATTCTCTAAA-1	aneuploid
CAGTACCAGTTTACGT-1	diploid
CAGTAGATGATGTCCG-1	aneuploid
CAGTAGCCCACGCGGT-1	aneuploid
CAGTCGAGGATGCAAT-1	aneuploid
CAGTCTGTATACTGGG-1	aneuploid
CAGTGAATAAATGACT-1	aneuploid
CAGTGGTTGCACATGA-1	aneuploid
CAGTGTCCGCAGAATG-1	aneuploid
CAGTGTCGGCTGGCCC-1	diploid
CAGTGTTAATCTCTCA-1	diploid
CAGTTCAAATTGACAC-1	aneuploid
CAGTTCCGCGGGTCGA-1	aneuploid
CAGTTCGAGGACCCGA-1	diploid
CATAACGGACAGTCGT-1	aneuploid
CATAAGAAGCTTGGCT-1	diploid
CATAAGCTCTCCGTCT-1	diploid
CATACAAAGCCGAACC-1	aneuploid
CATACACGGTTCCCAC-1	diploid
CATACCCGTACCCAGT-1	aneuploid
CATACGGCGTCTGGGC-1	aneuploid
CATACGGGTGCATGAT-1	aneuploid
CATACTATGTAATTGT-1	aneuploid
CATACTTAGGCAATAC-1	diploid
CATACTTCTTTCTCCG-1	diploid
CATAGAGGAGATACTA-1	diploid
CATAGCGTTGCCCACC-1	diploid
CATAGGGACACTTGTG-1	diploid
CATAGTACATTGAGAG-1	aneuploid
CATAGTAGCATAGTAG-1	aneuploid
CATAGTCAAATACATA-1	diploid
CATAGTCCACAAGAAC-1	aneuploid
CATATACTACTGATAA-1	aneuploid
CATATAGGTACAGTCA-1	aneuploid
CATATGTCAGGCTACG-1	diploid
CATCAACACCTACTAA-1	aneuploid
CATCATTACCCTGAGG-1	diploid
CATCCGCAGGCCCGAA-1	aneuploid
CATCCTCTCAAAGATC-1	diploid
CATCGCCCGCGGCCAA-1	aneuploid
CATCGGACGGGTTAAT-1	aneuploid
CATCGTCCGGTTACTA-1	aneuploid
CATCTAGTGAAGGGAA-1	diploid
CATCTATCCCGTGTCT-1	aneuploid
CATCTGCAGGATCATT-1	aneuploid
CATCTTACACCACCTC-1	aneuploid
CATGAACCGACATTTG-1	aneuploid
CATGACTTCGCTGAAT-1	diploid
CATGATGCACAATTCT-1	aneuploid
CATGCACATGAGAGGC-1	diploid
CATGCCAACTCGCAAA-1	aneuploid
CATGCGACCAGTTTAA-1	aneuploid
CATGCGTTAGACAGAA-1	diploid
CATGCGTTGAGAGGAG-1	diploid
CATGCTGGCTCCAATT-1	aneuploid
CATGGCAGGAAGATCG-1	aneuploid
CATGGGTCGGGTGTGG-1	aneuploid
CATGGTAAGTAGCGTT-1	aneuploid
CATGTAAGAGACATTT-1	diploid
CATGTCTCATTTATGG-1	aneuploid
CATTACATAGATTGTG-1	diploid
CATTACGTCGGCCCGT-1	aneuploid
CATTCAGGTCAGTGCG-1	aneuploid
CATTCCCATTCCGTCG-1	aneuploid
CATTCCCTAAGTACAA-1	aneuploid
CATTGATGAACACGCC-1	diploid
CATTGCGAAATGGGCG-1	aneuploid
CATTGCGGGTCAATTC-1	diploid
CATTGTGTGCTAGATC-1	aneuploid
CATTTAGCGGACCATG-1	aneuploid
CATTTCTAGCAGACTA-1	aneuploid
CATTTGAGTGGTACGT-1	aneuploid
CCAAACAGAACCCTCG-1	aneuploid
CCAAAGCAGTTGGTTG-1	aneuploid
CCAAATCAAAGGGCAA-1	diploid
CCAACGATGCACTGAT-1	aneuploid
CCAACTTGATAGATCC-1	diploid
CCAAGAAAGTGGGCGA-1	diploid
CCAAGACTTCTGCGAA-1	aneuploid
CCAAGCGTAACTCGTA-1	aneuploid
CCAAGGAACAGAGAGG-1	aneuploid
CCAAGTTTCTACAGAT-1	aneuploid
CCAATAGATTTCATCT-1	aneuploid
CCAATAGTGCCGTCGA-1	aneuploid
CCAATCGGTAGATCGA-1	diploid
CCAATGTCACAGCAAG-1	aneuploid
CCAATTACGGGTCGAG-1	aneuploid
CCAATTGAATGTTAAT-1	aneuploid
CCACAATGTACGTCTT-1	aneuploid
CCACACTGAGATATTA-1	aneuploid
CCACAGTACCCATCCT-1	aneuploid
CCACATGGCTCTTTAT-1	diploid
CCACCAACTTTACTGT-1	diploid
CCACCCAAGGAAAGTG-1	aneuploid
CCACCTGTATGGAATA-1	diploid
CCACGAATTTAACCTC-1	diploid
CCACGAGAAGAGAATC-1	aneuploid
CCACGGCAGGTGTAGG-1	diploid
CCACGGTGCCCGGTAG-1	diploid
CCACGTAAATTAGACT-1	diploid
CCACTAAACTGAATCG-1	aneuploid
CCACTATCCGGGTCAC-1	aneuploid
CCACTCAGATCCGCAA-1	diploid
CCACTGGTGGCTGGTT-1	aneuploid
CCAGAAAGCAACTCAT-1	diploid
CCAGAGACAAAGCCGG-1	aneuploid
CCAGATAGTTGAGTGA-1	aneuploid
CCAGCCTGGACCAATA-1	aneuploid
CCAGCGGGATCACCAG-1	diploid
CCAGCTACGCCTCATA-1	aneuploid
CCAGCTGATGGTACTT-1	aneuploid
CCAGCTTCCGCCCGCA-1	aneuploid
CCAGGCTGGCGTCTGA-1	diploid
CCAGGGACGTGGCCTC-1	aneuploid
CCAGTAGTCTGATCCA-1	aneuploid
CCAGTCAAATCTCTTA-1	diploid
CCAGTCTAGACGGCGC-1	aneuploid
CCAGTCTTGTCATAGA-1	diploid
CCAGTGTACAGACCGA-1	diploid
CCATAAACAACCCGAC-1	aneuploid
CCATACCTTTACTTGT-1	aneuploid
CCATACTCGCCTCTCC-1	aneuploid
CCATAGAGGCTGCCAG-1	diploid
CCATAGGTTGGCGTGG-1	aneuploid
CCATAGTCAGTAACCC-1	aneuploid
CCATATGGAAACTATA-1	diploid
CCATCCATACCAAGTC-1	aneuploid
CCATCGCAGTTAAACT-1	aneuploid
CCATCTCACCAGTGAA-1	aneuploid
CCATGCCTGTTTAGTA-1	aneuploid
CCATGGCAAACGCTCA-1	diploid
CCATGGCCCTTGTACC-1	aneuploid
CCATTAGCGATAATCC-1	aneuploid
CCATTCCCTGCCCACA-1	aneuploid
CCCAAACATGCTGCTC-1	aneuploid
CCCAACATACGTCGCG-1	aneuploid
CCCAATGAGATTTGCA-1	diploid
CCCAATTTCACAACTT-1	aneuploid
CCCACTCCACGGTATC-1	diploid
CCCAGAGGAGGGCGTA-1	aneuploid
CCCAGTTAAGGCGCCG-1	aneuploid
CCCGAAGTTTCGCGAA-1	diploid
CCCGACCATAGTCCGC-1	aneuploid
CCCGAGTTTCTCCGTA-1	diploid
CCCGCAGCGCGAACTA-1	aneuploid
CCCGCCATGCTCCCGT-1	aneuploid
CCCGCGCAATGCACCC-1	aneuploid
CCCGGCTAGGTGAGAA-1	aneuploid
CCCGGTGGAAGAACCT-1	aneuploid
CCCGGTGTATCGGAAT-1	diploid
CCCGTAAGTCTAGGCC-1	aneuploid
CCCGTCAGCGTCTGAC-1	aneuploid
CCCGTGAGGGCGGTGA-1	diploid
CCCTATGTAGAGCAGA-1	diploid
CCCTCAAGCTCTTAGT-1	aneuploid
CCCTCAGATCGAGAAC-1	diploid
CCCTCATTCTGGAATT-1	aneuploid
CCCTCCTCGCTCGTAT-1	diploid
CCCTGAAATGAGTTGA-1	aneuploid
CCCTGACTAACAAATT-1	aneuploid
CCCTGATGTAACTCGT-1	aneuploid
CCCTGCCCAATCCGCT-1	aneuploid
CCCTGCGCTACGCATA-1	aneuploid
CCCTGTTGGCAAAGAC-1	aneuploid
CCCTTTGACAGGTCTT-1	aneuploid
CCGAAAGTGGTGAGCA-1	aneuploid
CCGAACACTGGGCCTC-1	diploid
CCGAACCTTCCCGGCC-1	aneuploid
CCGAAGCATTGACCAA-1	diploid
CCGAAGTATATTGTTC-1	aneuploid
CCGACAAACACATGAG-1	aneuploid
CCGACAAAGGGAGTGC-1	aneuploid
CCGACGGGCATGAGGT-1	diploid
CCGAGAAGTCGCATAA-1	diploid
CCGAGCTGTGCTTGTC-1	diploid
CCGATCTCAACCTTAT-1	aneuploid
CCGATTCGAGGGACCC-1	aneuploid
CCGCACAAAGACCAAC-1	aneuploid
CCGCACACGAACGTGT-1	diploid
CCGCACGTGACCTCGG-1	aneuploid
CCGCATGTGGTACGAT-1	diploid
CCGCCGGTCAACACAC-1	aneuploid
CCGCCGTTGAGGATAA-1	diploid
CCGCCTTGCGATGTCG-1	diploid
CCGCGATTTGGTAGGT-1	aneuploid
CCGCGCAAGATACCCA-1	diploid
CCGCGGGTACGAAGAA-1	aneuploid
CCGCGTAGGTAAGGGC-1	aneuploid
CCGCTATCAGCACCAG-1	aneuploid
CCGCTCCAGGGCGATC-1	diploid
CCGCTTACCTCACTCT-1	aneuploid
CCGCTTGCTGACATGG-1	aneuploid
CCGGAATGGTTTCAGT-1	aneuploid
CCGGAGCGTACTTTCT-1	diploid
CCGGCACGACCGTTTC-1	diploid
CCGGCCGCGAGCATAT-1	diploid
CCGGCGCATATTGGAT-1	aneuploid
CCGGCGTGAGACTCTG-1	diploid
CCGGGACCCGCAGAGA-1	aneuploid
CCGGGCGGTCTCGTCA-1	aneuploid
CCGGGCTAAGAATTTC-1	diploid
CCGGGCTGCTCCATAC-1	aneuploid
CCGGGTTCGAGGTTAC-1	aneuploid
CCGGTAATGGCTAGTC-1	diploid
CCGGTGCGAGTGATAG-1	aneuploid
CCGGTTTGTAATTGTG-1	diploid
CCGTAAGTTGGTCCCA-1	aneuploid
CCGTACCCAAGCGCCA-1	aneuploid
CCGTAGGAAATCCCTG-1	diploid
CCGTATTAGCGCAGTT-1	diploid
CCGTCAACCTCTGGCG-1	diploid
CCGTGAGGCATTCATG-1	diploid
CCGTGCCCATGACGGC-1	aneuploid
CCGTGGAACGATCCAA-1	aneuploid
CCGTGTTAAATTCCAT-1	diploid
CCGTTACGTTAGAACA-1	aneuploid
CCGTTCCGAATCTCGG-1	aneuploid
CCTAAAGGCTGACGCT-1	aneuploid
CCTAAATTAACGGTTC-1	aneuploid
CCTAACCCAAACAAGT-1	aneuploid
CCTAACTAAGGCTCTA-1	aneuploid
CCTACATTCACAGACG-1	diploid
CCTACGGCTCAGTCGA-1	aneuploid
CCTACTCAACACGATT-1	diploid
CCTACTGCTTACACTT-1	diploid
CCTAGGCGTAGCGATC-1	aneuploid
CCTATATCGTGTCACG-1	diploid
CCTATCTATATCGGAA-1	aneuploid
CCTATGAAGTGGTGCC-1	diploid
CCTATGGCTCCTAGTG-1	diploid
CCTATGGGTTACCGTC-1	aneuploid
CCTATGTCCACTCCAC-1	diploid
CCTCACCAATCTTGAC-1	aneuploid
CCTCACCTGAGGGAGC-1	aneuploid
CCTCACCTTAGCATCG-1	aneuploid
CCTCACGTCAGCTAAT-1	diploid
CCTCCGACAATTCAAG-1	aneuploid
CCTCCTAGCTAGAGTC-1	diploid
CCTCCTGAGCCCACAT-1	aneuploid
CCTCGAAGTGGACGGG-1	aneuploid
CCTCGCCAGCAAATTA-1	aneuploid
CCTCGCGCGATATAGG-1	aneuploid
CCTCGCGCTGTGCGAT-1	diploid
CCTCGGACCGGGATAG-1	aneuploid
CCTCGGATGCTACCTG-1	aneuploid
CCTCGGTTTCCTTGCC-1	diploid
CCTCTAATCTGCCAAG-1	aneuploid
CCTCTACAAGGATTGG-1	diploid
CCTCTCTCCCATCTAG-1	aneuploid
CCTCTGGCCTAGACGG-1	aneuploid
CCTCTGTACTATTCTA-1	diploid
CCTGAACGATATATTC-1	aneuploid
CCTGAATATTTACATA-1	aneuploid
CCTGACAAACTCGCGC-1	aneuploid
CCTGACCACCGATGGT-1	aneuploid
CCTGCCCGTTGTCTAG-1	aneuploid
CCTGCGATAGAACTGT-1	aneuploid
CCTGCGTTCTACGCTT-1	aneuploid
CCTGCTATTTGAGAAG-1	aneuploid
CCTGGAAACGTTCTGC-1	diploid
CCTGGCTAGACCCGCC-1	aneuploid
CCTGGTCGAATGTGGG-1	diploid
CCTGTACTCACGCCCA-1	aneuploid
CCTGTCACCCGGGCTC-1	aneuploid
CCTGTCCCTCACGTTA-1	diploid
CCTGTCGCCCGTAAAT-1	aneuploid
CCTGTGAAACCGTAAC-1	aneuploid
CCTGTGCATAGGAGAC-1	aneuploid
CCTGTTCAACCTCGGG-1	diploid
CCTTCAGTTAAAGTGA-1	diploid
CCTTCCGCAACGCTGC-1	diploid
CCTTCGTATAGAATCC-1	diploid
CCTTCTCAGCGTTCCT-1	diploid
CCTTCTTGATCCAGTG-1	aneuploid
CCTTGTGAACGTGGTT-1	diploid
CCTTTCAATGAAGAAA-1	aneuploid
CGAAACGCAATTCATG-1	aneuploid
CGAACAGTATGGGCGT-1	diploid
CGAACCCGCATGCGTC-1	aneuploid
CGAACGCCCAGTGCCG-1	aneuploid
CGAACGGCCGGACAAC-1	diploid
CGAAGACGGTGAGTGC-1	aneuploid
CGAAGCCACAGCATGG-1	diploid
CGAAGCTATAAATTCA-1	aneuploid
CGAAGTTGCTCTGTGT-1	aneuploid
CGAATCTGCTCGACGC-1	diploid
CGAATGAAGTCATTGC-1	diploid
CGAATGACGCATAATG-1	diploid
CGACAATTTGATCTAA-1	aneuploid
CGACACGCTCCGACAG-1	aneuploid
CGACAGTTCGCGTTAT-1	aneuploid
CGACCCTTAACGCCGG-1	diploid
CGACCTACTAGACAAT-1	diploid
CGACTCAGGATGTTAT-1	aneuploid
CGACTTTGTATAGCCT-1	aneuploid
CGAGACCCTAGAGTGT-1	aneuploid
CGAGAGATGTGAACCT-1	aneuploid
CGAGAGCGCGTAGATA-1	diploid
CGAGCCGAGCACTCGA-1	aneuploid
CGAGCGTTGATCAGCC-1	aneuploid
CGAGCTGGGCTTTAGG-1	aneuploid
CGAGGATCGGGAACGA-1	diploid
CGAGGCCAGGCATTGG-1	aneuploid
CGAGGGACTGCGGTCG-1	aneuploid
CGAGGGTATCCAGGTG-1	diploid
CGAGTACTAAAGAGGA-1	aneuploid
CGAGTTCTGTCCCACC-1	aneuploid
CGAGTTTATCGGACTG-1	aneuploid
CGATAATACTCAGGTT-1	diploid
CGATACCTCGCGGACA-1	aneuploid
CGATAGCGATACAGTG-1	diploid
CGATAGTCGTACTGCA-1	diploid
CGATCCACCATTGTTG-1	diploid
CGATCCGACCCAGTGC-1	aneuploid
CGATCTGTTGGAGGAC-1	diploid
CGATGGACCCTACGCC-1	aneuploid
CGATGTTGTTATCTAC-1	diploid
CGATTAAATATCTCCT-1	diploid
CGATTCGCCTGGCTGC-1	diploid
CGCAAACACGAGTTAC-1	aneuploid
CGCAATCGATCATTAG-1	aneuploid
CGCAATTACTTTCGGT-1	aneuploid
CGCAATTAGGGTAATA-1	aneuploid
CGCAATTCTACAATAA-1	aneuploid
CGCACATGTCCACTAC-1	aneuploid
CGCACGTGCGCTATCA-1	aneuploid
CGCAGATCTTCACCCG-1	diploid
CGCATCCATCAGCCAG-1	diploid
CGCATGGTGCGATGCT-1	aneuploid
CGCCAAGAAGCCGAGT-1	aneuploid
CGCCACCCGCATTAAC-1	aneuploid
CGCCATCCGATTATGA-1	aneuploid
CGCCCAGCACGCCTAG-1	diploid
CGCCCGCTTCCGTACA-1	aneuploid
CGCCCTAATTGTTCAA-1	diploid
CGCCCTTGAAGGCTGA-1	aneuploid
CGCCGACTATTCGCTA-1	aneuploid
CGCCGCCCATGCCTGT-1	aneuploid
CGCCGCGTTCTGAACG-1	diploid
CGCCGTTCAGCATAGT-1	diploid
CGCCTCCCTCCTCTAT-1	aneuploid
CGCCTGGCCTACGTAA-1	aneuploid
CGCCTTTAGCATGCTC-1	diploid
CGCGACACTGCGCAGC-1	aneuploid
CGCGAGAGGGACTTGT-1	diploid
CGCGAGTCTGCCGGGT-1	diploid
CGCGCATGTTTGATTG-1	aneuploid
CGCGCCCGACTTAATA-1	aneuploid
CGCGGCTCAACTTGAA-1	aneuploid
CGCGGGAATTAGGCAG-1	aneuploid
CGCGGTAAGTCTAGCT-1	diploid
CGCGGTACGGTATACA-1	diploid
CGCGGTCACAAACCAA-1	diploid
CGCGTGGGCCTGTGTT-1	diploid
CGCGTTCATGAAATAC-1	aneuploid
CGCTACGGGACATTTA-1	aneuploid
CGCTAGAGACCGCTGC-1	aneuploid
CGCTATACCGCCCACT-1	diploid
CGCTATTCAATGTATG-1	aneuploid
CGCTATTCTTAGGCTC-1	aneuploid
CGCTCGACATAATGAT-1	aneuploid
CGCTCTCCGTAGATTA-1	aneuploid
CGCTGGTGACTACCCT-1	diploid
CGCTGTGACGCCGCAC-1	aneuploid
CGCTGTGTGGATGTTG-1	diploid
CGCTTATTCCCGGTCG-1	diploid
CGCTTCCACTGAAATC-1	aneuploid
CGCTTGGACGGATAGA-1	diploid
CGCTTTCTTGCATTCG-1	aneuploid
CGGAAAGCAAATGTGC-1	aneuploid
CGGAACGTAAACATAG-1	diploid
CGGACCTTTACGTCCC-1	diploid
CGGACGTTACTTGAAG-1	diploid
CGGAGCAATTTAATCG-1	diploid
CGGAGCATGGCGATCC-1	aneuploid
CGGAGTTTGAGAGACA-1	aneuploid
CGGATAAGCGGACATG-1	diploid
CGGATCCTCAAGGACT-1	diploid
CGGATGAATGCTGTGA-1	diploid
CGGCAAACATCGTGCG-1	aneuploid
CGGCAGGGTCGGGTTG-1	aneuploid
CGGCCACGCACAAAGT-1	aneuploid
CGGCCAGAGCGACCAT-1	diploid
CGGCCCAACCTGTAGT-1	aneuploid
CGGCCCAGGTATATCC-1	diploid
CGGCGCCATCAATCCC-1	diploid
CGGCTCTAAAGCTGCA-1	diploid
CGGGAAGTACCGTGGC-1	diploid
CGGGAATATAGTATAC-1	diploid
CGGGAATTTATGTAAA-1	aneuploid
CGGGAGCTTCAGTGTA-1	aneuploid
CGGGAGTATACCGCCG-1	aneuploid
CGGGATCAATGTAAGA-1	aneuploid
CGGGCAGCTAAACCGC-1	aneuploid
CGGGCCATAGCCGCAC-1	aneuploid
CGGGCCTTCTTTGTAA-1	aneuploid
CGGGTGTACCCATTTA-1	aneuploid
CGGTACTAGAATCAAA-1	aneuploid
CGGTAGAGGTGCAGGT-1	aneuploid
CGGTCAAGTGGGAACC-1	aneuploid
CGGTCTATCAACCCGT-1	aneuploid
CGGTGAAGACTAAAGT-1	aneuploid
CGGTGCAGATAGAACG-1	aneuploid
CGGTGCGCGTTGGTCC-1	aneuploid
CGGTGTACTTGATCCC-1	aneuploid
CGGTTATCCAACAGTG-1	aneuploid
CGGTTCAAGTAGGTGT-1	aneuploid
CGGTTCCGGCTTCTTG-1	aneuploid
CGGTTGACCTGGCATA-1	aneuploid
CGTAAACGCTTGAGTG-1	aneuploid
CGTAAAGCAAGAAATC-1	diploid
CGTAACTTCGACACTT-1	diploid
CGTAATAATTACGAGT-1	aneuploid
CGTACCGAAAGTCTAG-1	aneuploid
CGTACCTGATAGGCCT-1	aneuploid
CGTATTAAGAGATCTA-1	aneuploid
CGTCAATCTTTAACAT-1	aneuploid
CGTCACGTCCATTGGT-1	diploid
CGTCAGCTATTTACTC-1	aneuploid
CGTCAGTGCGCACAAG-1	aneuploid
CGTCATACCATATCCA-1	aneuploid
CGTCCAGATGGCTCCA-1	aneuploid
CGTCGCTTGGTTATAC-1	diploid
CGTCGGATAGTGTTGA-1	aneuploid
CGTCGTCCTTCGCGAA-1	diploid
CGTCTGGAAGGGCCCG-1	aneuploid
CGTCTTGAGTGTGACG-1	diploid
CGTGAAGTTAATTCAC-1	aneuploid
CGTGACATTGGGTCGT-1	aneuploid
CGTGCAGACTGGGACA-1	aneuploid
CGTGCATTGTCGACGC-1	aneuploid
CGTGCCCTCCCGAAGA-1	aneuploid
CGTGCTTCTACCTAAA-1	diploid
CGTGGCCGAATATCTA-1	diploid
CGTGGTACCCAAAGGC-1	diploid
CGTGTGTTAAACCCTG-1	diploid
CGTTAGCTCACAACTG-1	aneuploid
CGTTATCATACTTCCA-1	aneuploid
CGTTCAAGGAAACGGA-1	diploid
CGTTCAGACCCGCGAA-1	diploid
CGTTCTTCGCACACCT-1	diploid
CGTTGAGCGACCGTCG-1	aneuploid
CGTTGTAAACGTCAGG-1	aneuploid
CGTTGTAAGATTGATT-1	aneuploid
CGTTGTCGGCAATTGA-1	diploid
CGTTGTTTCAATTCCC-1	aneuploid
CGTTTCACTTCGGGCG-1	aneuploid
CGTTTCGCTCATTACA-1	aneuploid
CGTTTGTGTAGAGGGT-1	diploid
CTAAAGAATGCCTACT-1	aneuploid
CTAAAGGGAAATAGGA-1	aneuploid
CTAAAGTCCGAAGCTA-1	aneuploid
CTAAATCCTATTCCGG-1	aneuploid
CTAACAGCACAATAAC-1	diploid
CTAACCGCGCGCCCGT-1	aneuploid
CTAACGAAACTTGCTG-1	aneuploid
CTAACTGATAATCGCC-1	diploid
CTAACTGGTCCGGTTC-1	diploid
CTAAGGGAATGATTGG-1	aneuploid
CTAATTCGCACGCGCT-1	aneuploid
CTAATTCTCAGATATT-1	aneuploid
CTAATTTCAACAACAC-1	aneuploid
CTACAAGAAATAACCC-1	diploid
CTACACTCGCAGATGG-1	diploid
CTACATATCGCGGGAC-1	diploid
CTACCCTAAGGTCATA-1	aneuploid
CTACGACTAGCTATAA-1	aneuploid
CTACGCACGGAGTACC-1	aneuploid
CTACGTGTTGCCACCA-1	aneuploid
CTACTATCATAGGTTT-1	diploid
CTACTATCTTTCAGAG-1	aneuploid
CTACTCAAGGTATAGT-1	diploid
CTACTCTAGGCCCGGC-1	aneuploid
CTACTGCCACCTGACC-1	aneuploid
CTAGATAAACTCCTCG-1	aneuploid
CTAGATGTGAGTGTAA-1	aneuploid
CTAGATTTACGACGGC-1	aneuploid
CTAGCATAGTATAATG-1	aneuploid
CTAGCCACAGGCGAGC-1	diploid
CTAGCCGATGTTATGA-1	aneuploid
CTAGGCGCCCTATCAG-1	diploid
CTAGGGATAGGGACAA-1	diploid
CTAGGTCTGAAGGAAT-1	aneuploid
CTAGGTTCGGACGTGA-1	diploid
CTAGTAGAAAGGGATT-1	aneuploid
CTAGTATTCGGAATTA-1	aneuploid
CTAGTCACGTCTTAAG-1	aneuploid
CTAGTGAAGGACAGGA-1	aneuploid
CTAGTTACAACCCGGT-1	diploid
CTAGTTGGGCCCGGTA-1	aneuploid
CTATAAGAGCCAATCG-1	aneuploid
CTATCGACGAAATACA-1	diploid
CTATCGGGTCTCAACA-1	aneuploid
CTATGAACACCTTGCC-1	diploid
CTATGCCCGAATGCAA-1	diploid
CTATGTCACTAGCCCA-1	aneuploid
CTATGTGAGTCACGGC-1	diploid
CTATTCATGTGTCCCA-1	aneuploid
CTATTTGCTTGGAGGA-1	diploid
CTATTTGGTTACGGAT-1	aneuploid
CTCAACTAACCCGGAT-1	diploid
CTCACATTTACTAAAT-1	diploid
CTCACCAGTACAAGTG-1	aneuploid
CTCACTGTGATACTTA-1	diploid
CTCACTTGGCTGGTAA-1	aneuploid
CTCAGATTGTGATAAG-1	diploid
CTCAGTCACGACAAAT-1	aneuploid
CTCATCACTTAGTGAT-1	diploid
CTCATGGTAATTTGCG-1	diploid
CTCATTCGTGAACATC-1	aneuploid
CTCATTGCTCTAACAA-1	diploid
CTCATTTGATGGGCGG-1	aneuploid
CTCCCTCCTTTCGATC-1	diploid
CTCCGCCCACATGAGG-1	aneuploid
CTCCGGCCTAATATGC-1	aneuploid
CTCCGGCTTGTAGACA-1	aneuploid
CTCCTAAGTTATGTCT-1	aneuploid
CTCCTAGTAATCGTGA-1	diploid
CTCCTCCAGCTCACAC-1	diploid
CTCCTGTTCAAGGCAG-1	diploid
CTCCTTTACGCAAGTC-1	aneuploid
CTCGAGACATACGATA-1	diploid
CTCGAGATCCAAAGCA-1	aneuploid
CTCGAGGCAAGTTTCA-1	diploid
CTCGAGGTCGAACAGT-1	aneuploid
CTCGATATTTGCGAGC-1	aneuploid
CTCGCACCTATATAGT-1	aneuploid
CTCGGGATAACACCTA-1	diploid
CTCGGGTTCTCTGGCC-1	diploid
CTCGGTACCACTGCTC-1	aneuploid
CTCGGTCCGTAGCCTG-1	aneuploid
CTCGGTTGTCGGCCCT-1	diploid
CTCGTCGAGGGCTCAT-1	diploid
CTCGTTACGGCTACCA-1	diploid
CTCGTTTCTAATGTTT-1	aneuploid
CTCTAATGCATTGATC-1	aneuploid
CTCTACACTGGCGATT-1	diploid
CTCTACATCCTGCGTG-1	diploid
CTCTAGCCCTCGGAAA-1	diploid
CTCTATTTGGCTGCAG-1	aneuploid
CTCTCACAATCGATGA-1	aneuploid
CTCTCGCTGTACTATG-1	aneuploid
CTCTCTAACTGCCTAG-1	diploid
CTCTGCAGGCATTCTT-1	diploid
CTCTGCGAAGCAAGCA-1	aneuploid
CTCTGGACGCCTGGTG-1	aneuploid
CTCTTCTATTGACTGG-1	diploid
CTCTTCTGGAAGTTAG-1	diploid
CTCTTGTCCCGCTTGG-1	diploid
CTGAAAGAGATCCGAC-1	aneuploid
CTGAATCCGAGACCTC-1	diploid
CTGAATTTATTGCCAG-1	aneuploid
CTGACTGCGCAGCTCG-1	aneuploid
CTGAGAAAGTTCGGCG-1	diploid
CTGAGCAAGTAACAAG-1	aneuploid
CTGAGCGAGACTTATT-1	diploid
CTGATAGTGTATCTCA-1	aneuploid
CTGATCCCTTTATGCA-1	diploid
CTGCACAACTACATAT-1	aneuploid
CTGCACCTAGTCCACA-1	diploid
CTGCAGAGAATCAGAG-1	diploid
CTGCAGGTGCTCGGCC-1	aneuploid
CTGCCAAGGTTGGAAG-1	aneuploid
CTGCCATGCATCACAT-1	aneuploid
CTGCCCACGAAGCGTT-1	aneuploid
CTGCCTCATATGCAAC-1	diploid
CTGCCTTTAATACCTT-1	diploid
CTGCCTTTCTAGTAAA-1	diploid
CTGCGACCTCGCCGAA-1	diploid
CTGCGGGTGAAATGTT-1	aneuploid
CTGCGTTACGATATAA-1	aneuploid
CTGCTGAGGCCACGAA-1	aneuploid
CTGCTGTCTAACGAGC-1	diploid
CTGCTTGGCGATAGCT-1	diploid
CTGCTTTATGTCCGCG-1	diploid
CTGGAAATGGATGCTT-1	aneuploid
CTGGAAGACACGGTGG-1	diploid
CTGGATTTACACTTGA-1	diploid
CTGGCATCCGAATGAG-1	diploid
CTGGCGACATAAGTCC-1	aneuploid
CTGGCGCACAGGTCTG-1	aneuploid
CTGGCGGGAATAAGTA-1	aneuploid
CTGGCTCCTGCGGGAT-1	aneuploid
CTGGCTGATTCATCCT-1	aneuploid
CTGGCTGCTAACGTAA-1	aneuploid
CTGGCTGGTTGTCAGT-1	diploid
CTGGGATAAATAATGG-1	aneuploid
CTGGGCCTGCTATATC-1	diploid
CTGGGTAGGCAGTTAA-1	aneuploid
CTGGGTTGAGTTAAAG-1	diploid
CTGGTAACACATAGAA-1	aneuploid
CTGGTAACGAGCTCTT-1	aneuploid
CTGGTCATTCCAATCC-1	aneuploid
CTGGTGAATGGGCCTA-1	diploid
CTGGTTTCGAGCAAGA-1	aneuploid
CTGTACTTCTTAGCAT-1	aneuploid
CTGTATGGTGTAGAAA-1	aneuploid
CTGTCAAATGGCTCGG-1	aneuploid
CTGTGCAGGGTAGGTC-1	aneuploid
CTGTGGTCGGGAGATA-1	diploid
CTGTTACCCAATCTAG-1	aneuploid
CTGTTCACTGCCTGTG-1	aneuploid
CTGTTCATCTCACGGG-1	aneuploid
CTGTTGGCTCTTCTGA-1	aneuploid
CTGTTGTTCAGTCGTA-1	diploid
CTTAAATAAGACCCAT-1	aneuploid
CTTACACGGTATTCCA-1	aneuploid
CTTACACTGGGAAATA-1	aneuploid
CTTAGCCTTCCACATG-1	aneuploid
CTTAGTAGGCCTACAG-1	aneuploid
CTTAGTGTAGTAGCAT-1	diploid
CTTATGCGCTCAGGGC-1	diploid
CTTATGTTGACTACCA-1	aneuploid
CTTCACGCCCTGGTAC-1	diploid
CTTCAGTGGTCGCCTA-1	diploid
CTTCATAGCTCAAGAA-1	aneuploid
CTTCATTGTCAGTGGA-1	aneuploid
CTTCGATTGCGCAAGC-1	diploid
CTTCGTAGATAGGTGA-1	aneuploid
CTTCTATGTTGAAGTA-1	aneuploid
CTTCTTACGTCGTATA-1	aneuploid
CTTGAGTTAGGGTAAT-1	aneuploid
CTTGCAACCGCCTCCT-1	diploid
CTTGCCCAGGCTCTAC-1	aneuploid
CTTGGCCAAGCTGGGA-1	diploid
CTTGTACTTGTTGACT-1	aneuploid
CTTGTCAACATTCGAG-1	aneuploid
CTTGTGAGGACAGCGG-1	aneuploid
CTTGTGAGTCTTTGAC-1	aneuploid
CTTGTGCTCACCGATT-1	aneuploid
CTTGTTGCTGAGTCAA-1	aneuploid
CTTTAACTTTCAAAGG-1	aneuploid
CTTTAATATTGGTCGA-1	aneuploid
CTTTACCGAATAGTAG-1	aneuploid
CTTTAGGAACACTGTT-1	aneuploid
CTTTAGTGCTATTATT-1	aneuploid
CTTTCTGTGCGGGCTT-1	diploid
CTTTGACGTCGCTTCT-1	diploid
CTTTGGCGCTTTATAC-1	aneuploid
CTTTGGCTTTAGTAAA-1	diploid
CTTTGGGATTGTTGCA-1	diploid
CTTTGTCGAATGCTCC-1	diploid
GAAACAGATGACCACC-1	aneuploid
GAAACATAGGAAACAG-1	diploid
GAAACCATGGTGCGCT-1	aneuploid
GAAACCGAATTACCTT-1	aneuploid
GAAACCTATACAAATG-1	diploid
GAAACTCGTGCGATGC-1	aneuploid
GAAAGAACAGCGTTAT-1	aneuploid
GAAAGCCCTTTGGACC-1	aneuploid
GAAAGTGACTAACTGC-1	aneuploid
GAAATACTAAACGTTT-1	aneuploid
GAAATATCACCATCAG-1	aneuploid
GAAATATGCTTGAATG-1	diploid
GAAATCGCGCGCAACT-1	aneuploid
GAAATCTGACCAAGTT-1	aneuploid
GAAATGGCGGTGTTAG-1	aneuploid
GAAATGGGATGTAAAC-1	aneuploid
GAAATTAGCACGGATA-1	aneuploid
GAAATTCACATCGCTG-1	aneuploid
GAAATTGTCTCTATAA-1	aneuploid
GAACACACATCAACCA-1	diploid
GAACAGATTACTAAAT-1	diploid
GAACCTCGACCTACAC-1	diploid
GAACCTTTAACGATCC-1	diploid
GAACGACCGAATGATA-1	aneuploid
GAACGATAAGTTAAAG-1	diploid
GAACGCGGGTCACACG-1	diploid
GAACGTCTCATGGTCG-1	aneuploid
GAACGTTAGGAAGACG-1	aneuploid
GAAGAAACGATATTGT-1	diploid
GAAGAACGGTGCAGGT-1	aneuploid
GAAGCCGGGTAAGCTC-1	aneuploid
GAAGCGTGAGGAATTT-1	aneuploid
GAAGCTCGGACCCGTC-1	diploid
GAAGCTCTTTGCTTAG-1	aneuploid
GAAGCTTGCTGACCGC-1	aneuploid
GAAGGACTAAATTGAA-1	aneuploid
GAAGGAGTCGAGTGCG-1	aneuploid
GAAGGCTACCATTGTT-1	diploid
GAAGGGCATAACCATG-1	aneuploid
GAAGTCAGTTGCACTA-1	diploid
GAAGTCTCCCTAGCGA-1	aneuploid
GAAGTGATTTATCGTG-1	aneuploid
GAAGTGCTGGATAGCT-1	aneuploid
GAAGTTTCCACTCAAT-1	aneuploid
GAATAGACGCGACCCA-1	aneuploid
GAATAGCATTTAGGGT-1	diploid
GAATAGCCCTGCGGTC-1	diploid
GAATCGACATGGTCAC-1	aneuploid
GAATCGCCGGACACGG-1	aneuploid
GAATCTGAACATTCTC-1	aneuploid
GAATGCCGAAATGACC-1	aneuploid
GAATGGGCTTATCGAC-1	aneuploid
GAATGTATGGCAGGTC-1	aneuploid
GAATGTGGTCCGGATT-1	aneuploid
GAATGTTGGGTAATCT-1	aneuploid
GAATTATAGTGAAAGG-1	aneuploid
GAATTCACCCGGGTGT-1	diploid
GAATTTCTCGCTGCAG-1	aneuploid
GACAAACATATGCAGG-1	aneuploid
GACAACGACCATTGAA-1	aneuploid
GACAACGCAGCTTACG-1	aneuploid
GACAAGAGATGAGATT-1	diploid
GACACAAGGGAAGAAA-1	aneuploid
GACACGAGTTAGAGGA-1	aneuploid
GACACTGAGTTCAGTG-1	aneuploid
GACAGATTTCTGGCTC-1	diploid
GACAGCCAGACCTGAC-1	aneuploid
GACAGGCACACACTAT-1	aneuploid
GACATACTGTCGCAGA-1	aneuploid
GACATCCGTCGAACTG-1	diploid
GACATCGATTTATAAC-1	diploid
GACATTTCGCCCAGCC-1	diploid
GACCAAACGTTGACTG-1	diploid
GACCAGAGCCCTGTAG-1	aneuploid
GACCCAATTATGATAC-1	diploid
GACCGACGTGAAAGCA-1	diploid
GACCGACTGAAGCGTC-1	aneuploid
GACCGTGCTGACGGTG-1	aneuploid
GACCGTTACATGCGAC-1	aneuploid
GACCTGGTCTGGGCGT-1	aneuploid
GACGACGATCCGCGTT-1	aneuploid
GACGAGGCTAATAAAC-1	diploid
GACGATATCACTGGGT-1	diploid
GACGCATACCCGTCGG-1	diploid
GACGCCGTAAAGGCTA-1	diploid
GACGCTTGCTTCTAAA-1	aneuploid
GACGGGTTGGCCCGTA-1	diploid
GACGGTCAATAGAAGC-1	aneuploid
GACGGTCCTAGGGTGT-1	diploid
GACGTGAGACTCCATG-1	aneuploid
GACGTTGCTCGGCGGC-1	diploid
GACTAAGATCATGCAC-1	aneuploid
GACTAAGTAGGCTCAC-1	aneuploid
GACTACAAAGCGGTGG-1	diploid
GACTCACCCACGTGAG-1	aneuploid
GACTCCCAGAATAAGG-1	aneuploid
GACTCGCGGGAATGAC-1	aneuploid
GACTGCACCAGCCCAG-1	aneuploid
GACTGCTGGTGAGAAA-1	diploid
GAGACTGATGGGTAGA-1	aneuploid
GAGACTTCGCGACCGA-1	diploid
GAGAGGGCGCGAGGTT-1	aneuploid
GAGAGGTGCATTCTGG-1	aneuploid
GAGAGTCTCGGGAGAG-1	diploid
GAGATCGATCTTACTC-1	diploid
GAGATCTGCTTGGCAT-1	aneuploid
GAGATCTGTCACTCCG-1	aneuploid
GAGATCTTCCATGACA-1	aneuploid
GAGATGGCTTTAATCA-1	diploid
GAGATGGGAGTCGACA-1	aneuploid
GAGCACCTGTGTCCAG-1	diploid
GAGCATCATCCCTGGG-1	aneuploid
GAGCCAGCTACCTGTG-1	diploid
GAGCGAGGGAGTACCG-1	aneuploid
GAGCGCGCACGAGTAG-1	diploid
GAGCGCTGTTAGGTAA-1	diploid
GAGCGGAATGCGGTGT-1	diploid
GAGCTCAACATGAGCG-1	diploid
GAGCTCTCGGACCTAA-1	aneuploid
GAGCTGTCGTCTCGGA-1	aneuploid
GAGGAATGGAGAGGTT-1	aneuploid
GAGGAGATCCTCATGC-1	aneuploid
GAGGCCCGACTCCGCA-1	diploid
GAGGCTATCAAAGTCG-1	aneuploid
GAGGGAGTCAGATCGC-1	diploid
GAGGGCATCGCGTATC-1	aneuploid
GAGGGCGCAGCTCTGC-1	aneuploid
GAGGTACGCGTGTCCC-1	diploid
GAGGTCCCAAAGATCT-1	aneuploid
GAGTAAGGCCACGGGA-1	diploid
GAGTACGGGTATACAA-1	aneuploid
GAGTATCAAAGTTACA-1	diploid
GAGTATGCCCGCCTTG-1	aneuploid
GAGTCAGACCAGAATC-1	diploid
GAGTCCGCTTACCGGA-1	aneuploid
GAGTCGACAGACCCTC-1	aneuploid
GAGTCTTGTAAAGGAC-1	diploid
GAGTGTCAACCAGAAA-1	diploid
GAGTGTGCGGTACCCA-1	aneuploid
GAGTTGATGGCAATTT-1	diploid
GAGTTGTCACCAGTCT-1	diploid
GATAAATCGGTGGATG-1	aneuploid
GATAACTCGCACTGTG-1	aneuploid
GATACGATGGGAGTCA-1	aneuploid
GATAGAACCCGCTAGG-1	diploid
GATAGCGTACCACGCG-1	aneuploid
GATAGGTAACGTTGAC-1	aneuploid
GATAGTGCGAGTAAGT-1	diploid
GATATCAGTATGTATC-1	aneuploid
GATATCTCATGCAATA-1	aneuploid
GATATGAGACACTAAC-1	aneuploid
GATATGCGGTAGCCAA-1	aneuploid
GATATGGATTACGCGG-1	aneuploid
GATATTGAGATTGGCG-1	aneuploid
GATATTTCCTACATGG-1	aneuploid
GATCATTCCAAACATT-1	aneuploid
GATCCCTTTATACTGC-1	aneuploid
GATCCGGGAATTAACA-1	aneuploid
GATCCTAAATCGGGAC-1	aneuploid
GATCCTCGACACTGGC-1	diploid
GATCGACACTATCTGA-1	aneuploid
GATCGCGGGCTCTCCA-1	aneuploid
GATCGCTACCCGATTT-1	diploid
GATCGCTATATCTCAG-1	aneuploid
GATCGCTGTGGTGCGT-1	diploid
GATCGGATAGAACCAT-1	aneuploid
GATCGGCGATAAGTCG-1	aneuploid
GATCGGTGGCCATAAC-1	aneuploid
GATCGTGACTGATATC-1	aneuploid
GATCTCGACGCTGTGG-1	diploid
GATCTGCTATCTAAGG-1	diploid
GATCTTCATTGTCCTC-1	aneuploid
GATCTTGGAGGGCATA-1	aneuploid
GATCTTTGCAGGGTAT-1	aneuploid
GATGACAAGTAGGGCA-1	diploid
GATGAGGAACCTTCGG-1	diploid
GATGCCAGCAGAAGGC-1	aneuploid
GATGCCTTCTGCGGCA-1	diploid
GATGCGAATGGTATTA-1	aneuploid
GATGCGTCCTGCATTC-1	aneuploid
GATGCTACAAGCGCCT-1	aneuploid
GATGCTACCTTCGATG-1	diploid
GATGCTGTATTTCATC-1	aneuploid
GATGGCGCACACATTA-1	aneuploid
GATGTTCAATCCACGA-1	aneuploid
GATGTTTGTGCGAGAT-1	aneuploid
GATTAACCGAAAGCCC-1	diploid
GATTACTGAATTTGGG-1	aneuploid
GATTCCGCGTTTCCGT-1	aneuploid
GATTCGACGGTTCACG-1	aneuploid
GATTGCTCCAGTTGCA-1	diploid
GCAAACCCTACATTAT-1	diploid
GCAAACGTAAGCGACC-1	diploid
GCAAACGTCGCCAGGT-1	diploid
GCAAATATTACGCTTT-1	aneuploid
GCAAATGAGGACACTT-1	diploid
GCAACACACTAGAACT-1	diploid
GCAACAGCAGTATGCG-1	diploid
GCAACCACCAGACCGG-1	aneuploid
GCAACCACGGCCGCGT-1	aneuploid
GCAACCCAAGTTGTTT-1	aneuploid
GCAACGGCTAGTTATG-1	diploid
GCAAGAATTCCTTGGC-1	aneuploid
GCAAGTGCACAGAGAA-1	aneuploid
GCAAGTGTAAAGCATG-1	diploid
GCACAAACCCTAGATG-1	diploid
GCACAAACGAGGCGTG-1	diploid
GCACAACCTCGGGCGT-1	diploid
GCACAAGTGGATCATA-1	aneuploid
GCACACACTGGTAGCC-1	diploid
GCACACAGCTATTACC-1	diploid
GCACACGCCCATGGTC-1	aneuploid
GCACAGCACGGGCCGA-1	diploid
GCACGCCGATTCCCGC-1	diploid
GCACGCCTACTTAGAT-1	diploid
GCACTAGTCGCGCTAT-1	aneuploid
GCACTGTGCAAATGTA-1	aneuploid
GCAGACCCAGCACGTA-1	aneuploid
GCAGATCCATAAGACT-1	diploid
GCAGATCCTCGCAAAT-1	aneuploid
GCAGATTAGGGATATC-1	aneuploid
GCAGCACACAGCCCAG-1	aneuploid
GCAGCCTATATCACAT-1	diploid
GCAGCGGTGGGCATTA-1	aneuploid
GCAGCTGTCAACGCAT-1	diploid
GCAGGAACTTAGATCT-1	diploid
GCAGGACTATAGAATA-1	aneuploid
GCAGGTAGAGTATGGT-1	aneuploid
GCAGTGCGGGCGGATG-1	diploid
GCAGTGTGGCTATAGG-1	diploid
GCAGTTCGATCCGAGC-1	diploid
GCATACGAGGTCTTTA-1	aneuploid
GCATAGAGCACTCAGG-1	aneuploid
GCATCCCTAACTTTGA-1	diploid
GCATGAGGGACGCGGC-1	aneuploid
GCATGGGTACTGACGC-1	diploid
GCATTCAAGGCAACGC-1	aneuploid
GCATTGTAATTCATAT-1	aneuploid
GCATTTCCAAGGCTCC-1	aneuploid
GCCAACCATTTCCGGA-1	aneuploid
GCCAAGAATACTTCTG-1	diploid
GCCAATAGGGCATCTC-1	aneuploid
GCCACAATTTAAGGAC-1	aneuploid
GCCACTCAGAGCGCGA-1	diploid
GCCACTCCTTACGGTA-1	diploid
GCCAGGAAAGAACACT-1	diploid
GCCAGGAGTAACCGAT-1	aneuploid
GCCAGGCTTAGTGGTA-1	aneuploid
GCCATATTGCACACAG-1	aneuploid
GCCATCGAGCTGCGTG-1	diploid
GCCATCGATGCTGCAT-1	aneuploid
GCCATTAGCCTCAAAC-1	diploid
GCCCACCAAGGCTGTC-1	aneuploid
GCCCAGTTGGTATGCC-1	aneuploid
GCCCGACTTCTTCCCG-1	diploid
GCCCGAGAGTCTAAAT-1	diploid
GCCCGATCTGTGGTCG-1	diploid
GCCCGATGCCCAGTTC-1	diploid
GCCCGCGCGTAAACGG-1	aneuploid
GCCCGCGCGTTTGACA-1	aneuploid
GCCCGTAATACCTTCT-1	aneuploid
GCCCTGAGGATGGGCT-1	diploid
GCCGAAATTCCTACGT-1	aneuploid
GCCGATTGGCCAAGCT-1	aneuploid
GCCGCTTGTGAGAAAC-1	aneuploid
GCCGGGTTAGGGTCGC-1	aneuploid
GCCGGTCGTATCTCTC-1	diploid
GCCGTCGGTTTCGGGC-1	diploid
GCCGTGGAAGAAATGT-1	diploid
GCCTACGTTCTGTGCA-1	diploid
GCCTAGCGATCTGACC-1	aneuploid
GCCTATAGTGTCAGGG-1	aneuploid
GCCTATTCCGATATAG-1	aneuploid
GCCTCATCTGGAAATA-1	aneuploid
GCCTCTATACATAGCA-1	diploid
GCCTTCAGCCCTACCG-1	aneuploid
GCCTTGTATATGCAGT-1	aneuploid
GCGAAACGATCGGGAG-1	diploid
GCGAAACTTAACTGGA-1	aneuploid
GCGAAGAATCTGACGG-1	diploid
GCGAAGCCATACCCGT-1	aneuploid
GCGACATGTAAACATC-1	aneuploid
GCGACCCAACCATCTG-1	diploid
GCGACGATAGTTGTAC-1	aneuploid
GCGACGGTAGTCTCCT-1	diploid
GCGAGAAACGGGAGTT-1	aneuploid
GCGAGAGGCCATGTAA-1	diploid
GCGAGAGTTGCGTCCA-1	aneuploid
GCGAGCGCATGCTCCC-1	diploid
GCGAGGCCCGAGCAGA-1	aneuploid
GCGAGTTCTGCAAAGA-1	aneuploid
GCGATGTCTGTGCTTG-1	aneuploid
GCGATTGTTAACGTTA-1	aneuploid
GCGCAAGAGCGCGCTG-1	aneuploid
GCGCATCCAGTCAGCA-1	aneuploid
GCGCCGTTCCACGATA-1	aneuploid
GCGCCTCCCACTCCGA-1	diploid
GCGCGGTCTAGTAACT-1	diploid
GCGCGTCATTGGTACA-1	aneuploid
GCGCTAATTGAATAGA-1	aneuploid
GCGCTATGCCGAGGCA-1	aneuploid
GCGCTCGATCACCTGT-1	diploid
GCGCTGATCCAGACTC-1	aneuploid
GCGCTGCTTTGCATTT-1	aneuploid
GCGCTGGCGGAAAGTC-1	aneuploid
GCGCTTAAATAATTGG-1	diploid
GCGGACCGCGTTGTGG-1	diploid
GCGGAGAGGGAGAACG-1	aneuploid
GCGGCAAAGTATTGCC-1	diploid
GCGGCTCTGACGTACC-1	aneuploid
GCGGCTTTAGCAAGTT-1	diploid
GCGGGAACCAGGCCCT-1	aneuploid
GCGGGCATTACGATGC-1	diploid
GCGGGCGAGCCTTACC-1	diploid
GCGGTAACCCAAATGA-1	aneuploid
GCGGTCCCTAGACGCA-1	aneuploid
GCGGTGAACTGCGCTC-1	aneuploid
GCGGTGCGGAGCATCG-1	aneuploid
GCGGTTCCCTATCATG-1	aneuploid
GCGTAAATGGCCATAA-1	aneuploid
GCGTCCCTAAGACATA-1	diploid
GCGTCGAAATGTCGGT-1	aneuploid
GCGTCGCCAGGGTGAT-1	diploid
GCGTCTCTGCATTGGG-1	aneuploid
GCGTGGTACTGGGTTA-1	aneuploid
GCGTTCGGAGACCGGG-1	aneuploid
GCTAAACCTGAGGTGA-1	aneuploid
GCTAACTGAAGTCTGA-1	diploid
GCTAAGTAAAGGCGAT-1	aneuploid
GCTAAGTAGTTTCTCT-1	aneuploid
GCTAATACCGAATGCC-1	aneuploid
GCTACAATCGAGGATA-1	diploid
GCTACAGTACGGACCG-1	diploid
GCTACGACTTATTGGG-1	diploid
GCTACTATAGTAGAGT-1	diploid
GCTAGACCGTCTACTG-1	diploid
GCTAGAGTAGAGATGT-1	diploid
GCTAGCTTGAATAGCT-1	diploid
GCTAGGCACCACGGAG-1	diploid
GCTAGTAGAGCTTGTA-1	aneuploid
GCTAGTTTCATTGAGG-1	aneuploid
GCTATACGTCTCGGAC-1	diploid
GCTATCATACTCATGG-1	diploid
GCTATCGCGGCGCAAC-1	aneuploid
GCTATGCCAGCTTATG-1	diploid
GCTCAACCTCTTAGAG-1	aneuploid
GCTCAATCCGTTTATT-1	diploid
GCTCAATGTAATACCG-1	diploid
GCTCATTGATCATATC-1	diploid
GCTCCATGCAAAGCAA-1	diploid
GCTCCCAGTCGGTCCA-1	diploid
GCTCCGCTCGCTTCAG-1	diploid
GCTCGCGGTTCCGCTC-1	aneuploid
GCTCGCTCATGTCCAA-1	aneuploid
GCTCGGAATTTAAAGC-1	aneuploid
GCTCTAAACCCTGACG-1	aneuploid
GCTCTATGTTACGTGC-1	aneuploid
GCTCTTTCCGCTAGTG-1	diploid
GCTGAGCAACGGTTCT-1	aneuploid
GCTGAGGCGTGAGTAT-1	aneuploid
GCTGCACGGTTTCTTA-1	aneuploid
GCTGCGCCTCCCACGT-1	aneuploid
GCTGCTAAGTAGTCGA-1	diploid
GCTGCTACTGCGTAGC-1	aneuploid
GCTGCTCTCCGGACAC-1	aneuploid
GCTGGCAGGTGCCGTG-1	aneuploid
GCTGGCATATTCACCT-1	aneuploid
GCTGGCGGCGCATGCT-1	diploid
GCTGGTTTAGGCCATA-1	diploid
GCTGTATTACTGGCCC-1	aneuploid
GCTGTTGCTACCGAAC-1	aneuploid
GCTTAATGTAACTAAC-1	aneuploid
GCTTACGTAGTTAGTA-1	diploid
GCTTATGAAGCAGGAA-1	aneuploid
GCTTCCAGCTTAGATT-1	aneuploid
GCTTCCGTCCCTAGAC-1	aneuploid
GCTTCGACGTTCAATC-1	diploid
GCTTGATGATAATCAG-1	aneuploid
GCTTGGATCGATTAGG-1	aneuploid
GCTTTCAGAGGAGGTG-1	aneuploid
GGAAACCTTGTTGAAT-1	aneuploid
GGAAACTAAATGGGCC-1	diploid
GGAAAGGGAATTGAGC-1	diploid
GGAAAGTGCCCATGCC-1	aneuploid
GGAACCCGAACAAGAA-1	aneuploid
GGAACCGTGTAAATTG-1	aneuploid
GGAACCTTGACTCTGC-1	diploid
GGAACGGCCTGCAGCC-1	aneuploid
GGAATGCGCTAGCGTG-1	aneuploid
GGACAAGCCATGATCG-1	diploid
GGACACAAGTTTACAC-1	diploid
GGACCAACAGGATAAC-1	aneuploid
GGACCTCTAGGCCGCC-1	diploid
GGACTAAGTCAGGAGT-1	aneuploid
GGACTCACAAATTAGG-1	diploid
GGACTCGAAGCTTTCA-1	diploid
GGACTCGACAGCGCAT-1	diploid
GGACTCGTGAGTGGTC-1	diploid
GGACTCTTCCGGTTGA-1	diploid
GGAGAAGTCATTGGCA-1	aneuploid
GGAGACGACACCTTTG-1	aneuploid
GGAGCAACATTTCAAG-1	diploid
GGAGCACCAAGAACTA-1	aneuploid
GGAGGGCTTGGTTGGC-1	aneuploid
GGAGTACACATGAGCT-1	aneuploid
GGAGTGCCGCCCTGGA-1	aneuploid
GGATCAGAGCCATCAG-1	diploid
GGATCATCCCGTACGC-1	diploid
GGATCCCTACCAGCTA-1	aneuploid
GGATCCGGAATATACT-1	aneuploid
GGATCTTGACTCAACC-1	diploid
GGATGAAGATCGCTGA-1	aneuploid
GGATGCTGGCGTTCCT-1	diploid
GGATGTCCTTACCGCA-1	aneuploid
GGATTAATCATGGACC-1	diploid
GGATTCAGTACGGTGG-1	aneuploid
GGATTTCACTTCTATA-1	aneuploid
GGCAAAGGCGCCAATA-1	diploid
GGCAAATTACTTTACT-1	aneuploid
GGCAAGCCCATAGTGG-1	diploid
GGCAAGGCGAAATAGC-1	aneuploid
GGCAATAGTCAATGAG-1	aneuploid
GGCACTCCACTGGGCA-1	aneuploid
GGCAGAGAGATCGGGA-1	aneuploid
GGCAGCAAACCTATGC-1	diploid
GGCAGCGGTAATCCTA-1	aneuploid
GGCATACAGGTAGCGG-1	aneuploid
GGCATATCGGTTCTGC-1	aneuploid
GGCCACACGAAAGCCT-1	aneuploid
GGCCCAGCTGGTTTGC-1	diploid
GGCCCTCACCCACTTA-1	aneuploid
GGCCTGCTTCTCCCGA-1	diploid
GGCCTTTGCAACTGGC-1	aneuploid
GGCGAAATCTAACTTG-1	aneuploid
GGCGCAGGACATCTTC-1	aneuploid
GGCGCATGAATTGATG-1	diploid
GGCGCGTTCGAGTTTA-1	aneuploid
GGCGCTCCTCATCAAT-1	aneuploid
GGCGGAGTAATATTAG-1	aneuploid
GGCGGGCTCTAAGAGT-1	diploid
GGCGGTAGGATCATTG-1	aneuploid
GGCGGTTTGCCGGTGC-1	aneuploid
GGCGTAGGGAAAGCTG-1	diploid
GGCGTCCTATCCGCTG-1	aneuploid
GGCTAAAGGGCGGGTC-1	aneuploid
GGCTACTATACACTCC-1	diploid
GGCTATTAAGTTGTAT-1	aneuploid
GGCTCCTCCACCTGTT-1	diploid
GGCTCGCGTTGAGGTA-1	aneuploid
GGCTCGTGCCACCAGC-1	aneuploid
GGCTCTGCTCCAACGC-1	aneuploid
GGCTGAAATAGCAAAG-1	aneuploid
GGCTGGCTAGCTTAAA-1	aneuploid
GGCTTGGCTCTCACCT-1	aneuploid
GGCTTTCAATAAGGGT-1	diploid
GGGAACGGGAGGTTAG-1	aneuploid
GGGAAGACGGTCTGTC-1	diploid
GGGAATGAGCCCTCAC-1	diploid
GGGAATTCTGTCCAGT-1	aneuploid
GGGACAGAGTTACTCC-1	diploid
GGGACTGCATAGATAG-1	aneuploid
GGGAGAACTCACAGTA-1	aneuploid
GGGAGGATGCCCGAAA-1	aneuploid
GGGAGTAATGGCTGGC-1	aneuploid
GGGAGTTAATGAGGCG-1	aneuploid
GGGATACGGTAATAAT-1	aneuploid
GGGATATTGATCGCCA-1	diploid
GGGATGGACCCGCGTC-1	diploid
GGGATGGTCGTAACCG-1	aneuploid
GGGATTTACCGCACCT-1	aneuploid
GGGCAACCGCACGTGC-1	diploid
GGGCACGAATTGGCCG-1	aneuploid
GGGCAGGATTTCTGTG-1	diploid
GGGCAGTCAACGCCAA-1	diploid
GGGCATGCATGTCGAG-1	diploid
GGGCCATTCGTGCTGG-1	diploid
GGGCCCGTCTTAAACA-1	aneuploid
GGGCCCTACGAAAGGG-1	aneuploid
GGGCCCTTATCTATAC-1	aneuploid
GGGCCGGCCGAAGTAC-1	aneuploid
GGGCGAATTTCTCCAC-1	aneuploid
GGGCGATATGTGTGAA-1	aneuploid
GGGCGATCCATAGGCC-1	diploid
GGGCGCAGCGTTACTC-1	diploid
GGGCGGCAAATGAATT-1	aneuploid
GGGCGGGTTCCCTACG-1	aneuploid
GGGCGTCACCACGTAA-1	diploid
GGGCGTCCACTGGCTC-1	aneuploid
GGGCGTGGTTTCCCAG-1	diploid
GGGCGTTTACATTCAT-1	diploid
GGGCTCATCGAACCCA-1	aneuploid
GGGCTGCCTAGGGCGA-1	aneuploid
GGGCTGGTTAGTCGCG-1	aneuploid
GGGTAATGCTGTGTTT-1	aneuploid
GGGTACACTCTGGAGG-1	aneuploid
GGGTACTTCATGAACT-1	aneuploid
GGGTATGTATGCACTT-1	aneuploid
GGGTATTCTAGCAAAC-1	diploid
GGGTCACCGTGACGGT-1	aneuploid
GGGTCATGCGTACCAT-1	aneuploid
GGGTCCTTGGAAGAAG-1	diploid
GGGTCGTGGCAAGTGT-1	aneuploid
GGGTGACACCTTAACT-1	aneuploid
GGGTGCATATGAAAGC-1	aneuploid
GGGTGTTTCAGCTATG-1	aneuploid
GGGTTAACATTTGAGT-1	diploid
GGGTTCAGACGAACAA-1	aneuploid
GGGTTTAGGATAGGAT-1	diploid
GGTAACCGGGAGGATA-1	diploid
GGTAACTATGTATCTG-1	aneuploid
GGTACAAACATGCTAT-1	aneuploid
GGTACACCAGATTTAT-1	diploid
GGTACATCTGGGACGA-1	aneuploid
GGTACCATTAAGACGG-1	aneuploid
GGTAGAAGACCGCCTG-1	diploid
GGTAGACCGTTGGGCG-1	diploid
GGTAGTGCTCGCACCA-1	aneuploid
GGTATAGTGACACATA-1	diploid
GGTATGAAAGAACTGA-1	aneuploid
GGTATTGCCGAGTTTA-1	aneuploid
GGTCAGTGGGTCCCAC-1	aneuploid
GGTCCACGTCTATTTG-1	diploid
GGTCCTTCATACGACT-1	aneuploid
GGTCGGATAAACGGCG-1	aneuploid
GGTCGGCCAGGAGCTT-1	aneuploid
GGTCGGTAATTAGACA-1	aneuploid
GGTCGGTCGTCCACAG-1	diploid
GGTCGTAAGCTCGCAC-1	diploid
GGTCTCCAAGTAGTGC-1	diploid
GGTCTCCGTCCAGGTT-1	diploid
GGTCTCTGAATGGACT-1	diploid
GGTCTGAGAATCTGGA-1	aneuploid
GGTGAAGTACAGGGAT-1	aneuploid
GGTGAGATGCAGATAA-1	aneuploid
GGTGATAAGGAGCAGT-1	aneuploid
GGTGATGAAGGAAGTG-1	aneuploid
GGTGATTTCATCTTGT-1	aneuploid
GGTGCATAAATGATTA-1	diploid
GGTGCGGATAAGTGGC-1	aneuploid
GGTGCTGATCACAAAG-1	aneuploid
GGTGCTGGTACACATT-1	aneuploid
GGTGGACTGCTCTGGC-1	diploid
GGTGTAAATCGATTGT-1	diploid
GGTTACCACCCTCGGG-1	aneuploid
GGTTACCCGACACTTT-1	diploid
GGTTAGCTATATGTCT-1	aneuploid
GGTTAGGCTTGGAGAA-1	aneuploid
GGTTAGTTACGGCGCC-1	aneuploid
GGTTCGGATTATACTA-1	aneuploid
GGTTCTACTCGTCTGA-1	aneuploid
GGTTGTGCTCTTGTCC-1	aneuploid
GGTTGTGTAGCCTGGC-1	aneuploid
GGTTTAATTACCATCG-1	diploid
GGTTTAATTGAGCAGG-1	diploid
GGTTTACAATCTCAAT-1	aneuploid
GGTTTAGCCTTTCTTG-1	diploid
GGTTTCAATCGGTCAG-1	aneuploid
GGTTTGAGTGCTGGAA-1	aneuploid
GGTTTGTGACCTGAGG-1	diploid
GTAACATCTAAGATAA-1	diploid
GTAACTACGTAGACCT-1	diploid
GTAAGCGGGCAGTCAG-1	aneuploid
GTAAGTAACAGTCTGG-1	aneuploid
GTAAGTAGGGTATACC-1	aneuploid
GTAAGTCCACACTCTA-1	diploid
GTAATAAAGGGCTCCC-1	aneuploid
GTAATCTGATTCTTCG-1	aneuploid
GTACACTTACCTGAAG-1	aneuploid
GTACAGAGGCAAGGGT-1	aneuploid
GTACGAGATTGCGACA-1	aneuploid
GTACGCTTCATTGCAC-1	aneuploid
GTACGTTTGCCCGTCA-1	aneuploid
GTACTAAGATTTGGAG-1	aneuploid
GTACTCCCTTATCGCT-1	aneuploid
GTACTCCTGGGTATGC-1	aneuploid
GTACTGAGGTCGTAAC-1	aneuploid
GTACTGCATGAAGCGT-1	aneuploid
GTACTGGAGTTAGACC-1	aneuploid
GTACTTGGGCACTTCT-1	aneuploid
GTAGAAACGGGTGGAG-1	aneuploid
GTAGACGTCGTTACAT-1	aneuploid
GTAGAGGGAGACAAGT-1	diploid
GTAGCCAAACATGGGA-1	aneuploid
GTAGCGGCTATACACT-1	aneuploid
GTAGCTCCGGGAGGCT-1	diploid
GTAGCTTCCTCTTGTT-1	aneuploid
GTAGTCGCGGGAATCA-1	diploid
GTAGTCTACGATATTG-1	diploid
GTAGTTCGAAGGCGAA-1	diploid
GTAGTTTAAGCACACG-1	diploid
GTATAATCTCCCGGAT-1	aneuploid
GTATAGGACTCAGTAG-1	aneuploid
GTATATGTTACGGCGG-1	aneuploid
GTATCAAACGTTAGCT-1	diploid
GTATCAAGGTACTTCC-1	diploid
GTATCGGGACGAGCTG-1	aneuploid
GTATCTCAGTCTTGAC-1	diploid
GTATCTCGGGCGCTTT-1	diploid
GTATCTTTCATAACCA-1	aneuploid
GTATGAAATTTCACTC-1	diploid
GTATGACGTGGGAAAC-1	aneuploid
GTATGTGGGTCTAGTT-1	aneuploid
GTATTAAGGCGTCTAA-1	aneuploid
GTATTCTGAGAAACGA-1	aneuploid
GTATTCTTACCGTGCT-1	aneuploid
GTCAAAGAAGTGGTGT-1	diploid
GTCAAAGTTTACATAG-1	aneuploid
GTCAACCAGGCCTATA-1	diploid
GTCAAGCGGACTCGGG-1	aneuploid
GTCACTCTCCAAATCT-1	aneuploid
GTCAGAATAGTCTATG-1	aneuploid
GTCAGACAGCGTTGGA-1	aneuploid
GTCAGTTTGGTAGTCG-1	aneuploid
GTCATCTCCTACAGCT-1	aneuploid
GTCATGCACCTCCGTT-1	aneuploid
GTCATGGACATGACTA-1	aneuploid
GTCATTAGAGCGAACG-1	aneuploid
GTCATTGCATTGACCC-1	aneuploid
GTCCACGTCGCATTCG-1	diploid
GTCCAGGCACGTGTGC-1	diploid
GTCCATTACTGCTACG-1	diploid
GTCCCAACGTAAAGTA-1	aneuploid
GTCCCAATCATCCCGC-1	aneuploid
GTCCGAGAGCAATCAT-1	aneuploid
GTCCGGACCTGAAATT-1	diploid
GTCCGGCTGAATTGCG-1	aneuploid
GTCCGGGTTCACATTA-1	diploid
GTCCTACAGGCGGCTC-1	aneuploid
GTCCTACGAATAGTCT-1	diploid
GTCCTATTGTTGTGGT-1	aneuploid
GTCCTTCTACAACCCA-1	aneuploid
GTCGAATTTGGGCGCT-1	diploid
GTCGCCGTTGTGTGTT-1	diploid
GTCGCGTAACCCGTTG-1	aneuploid
GTCGGATATCTCAGAC-1	aneuploid
GTCGGATGTAGCGCGC-1	diploid
GTCGGGAACATGGTAG-1	aneuploid
GTCGTACCATCTCGGG-1	aneuploid
GTCGTACCTACGATTG-1	aneuploid
GTCGTATTGGCGTACA-1	aneuploid
GTCGTCAATTATAAGG-1	aneuploid
GTCGTGTCTGGTCATC-1	diploid
GTCGTTATTCGCTTAT-1	aneuploid
GTCTACTCAATTACAA-1	aneuploid
GTCTATACACGCATGG-1	diploid
GTCTATCTGAGTTTCT-1	aneuploid
GTCTATTGGTTCCGGT-1	aneuploid
GTCTCCGCCTCAATAC-1	diploid
GTCTCGACTAAGTTTG-1	aneuploid
GTCTCGATCTGCTTTC-1	aneuploid
GTCTGGGCGGTCGAGA-1	aneuploid
GTCTGTAGGTTGAACA-1	diploid
GTCTTCCTCACCTAAG-1	aneuploid
GTGAAACGGCGCCACC-1	aneuploid
GTGAAACGTGCTCCAC-1	aneuploid
GTGAACTCCCATTCGA-1	aneuploid
GTGAAGATTTCAAGTG-1	aneuploid
GTGAAGCCGTATAGTC-1	aneuploid
GTGACCGCACACTACG-1	aneuploid
GTGACGAGGGTGACCC-1	diploid
GTGACGCAGGTTTCAT-1	diploid
GTGACTTCAGTAGTGC-1	aneuploid
GTGAGATAACCTTATA-1	diploid
GTGAGCGTGCTGCACT-1	aneuploid
GTGAGGACACTTAAGG-1	aneuploid
GTGAGTCTAAGACGGA-1	aneuploid
GTGAGTGGTACAACGC-1	diploid
GTGATCAAGCGTGCAC-1	diploid
GTGATCACTAACGCCT-1	aneuploid
GTGATCATAGATCTGC-1	aneuploid
GTGATCCTTGTCATGA-1	diploid
GTGATTCGCCGCTCAA-1	aneuploid
GTGCAACAAATGTGGC-1	aneuploid
GTGCACCAGCTTCAAC-1	diploid
GTGCACGAAAGTGACT-1	aneuploid
GTGCCATCACACGGTG-1	diploid
GTGCCCGTTCGGATTC-1	aneuploid
GTGCCGCTTCAAAGGT-1	aneuploid
GTGCCTAGCTATGCTT-1	aneuploid
GTGCCTGAGACCAAAC-1	diploid
GTGCGAAATCGAACAC-1	aneuploid
GTGCGACAGGGAGTGT-1	aneuploid
GTGCGGGTCTCCAAAT-1	aneuploid
GTGCGTGTATATGAGC-1	aneuploid
GTGCTCAAGTACTGTC-1	aneuploid
GTGCTGCAGATAAGGA-1	aneuploid
GTGCTTACATCAGCGC-1	diploid
GTGGACCAACCCGATT-1	aneuploid
GTGGACGCATTTGTCC-1	diploid
GTGGACGTGCTGAGAC-1	aneuploid
GTGGAGCGTTTACCGA-1	diploid
GTGGAGTCGGCGGTTG-1	diploid
GTGGCAAACAGCGGCA-1	diploid
GTGGCCGGTTTCTCGG-1	diploid
GTGGCCTAATATCATT-1	aneuploid
GTGGCGGTCCCAGCGT-1	diploid
GTGGGAACAAACCGGG-1	diploid
GTGGGAAGACTGAATC-1	diploid
GTGGGCTTAGACACAC-1	aneuploid
GTGGTGGCCAAGTGAA-1	aneuploid
GTGGTTACTTCTTTCG-1	aneuploid
GTGGTTTCCGCCTTTC-1	aneuploid
GTGTATATCAGCGGGC-1	diploid
GTGTGAATAACTTAGG-1	aneuploid
GTGTGTCGACGTCGCT-1	aneuploid
GTGTTACTATGCGTCC-1	aneuploid
GTTAAAGTAGGACTGG-1	aneuploid
GTTAACATCACTTAAA-1	diploid
GTTAACTATGTTGTCA-1	diploid
GTTAAGGGTGCGATGT-1	diploid
GTTAAGTTAGAGTGGG-1	diploid
GTTAATGTCTATCTTA-1	aneuploid
GTTACAATTGGTGACG-1	aneuploid
GTTACCTACAACTTGC-1	aneuploid
GTTACTTTGGGCCTAG-1	aneuploid
GTTAGCCCATGACATC-1	diploid
GTTAGCCGTAAATCAA-1	aneuploid
GTTAGGCTACCCGTTT-1	diploid
GTTATAATACGGTGAA-1	diploid
GTTATATCAGGAGCCA-1	diploid
GTTATATTATCTCCCT-1	aneuploid
GTTATTAACGTGGGAG-1	aneuploid
GTTCAAATCAGATGTC-1	aneuploid
GTTCACAGGAGTCTAG-1	aneuploid
GTTCAGTCGCCAAATG-1	diploid
GTTCATCGTTTGGCTG-1	aneuploid
GTTCCGTCCGCCTGCA-1	diploid
GTTCGACAATTGTATA-1	diploid
GTTCGCCATAAGTGCC-1	aneuploid
GTTCGCTGAGACGTCT-1	diploid
GTTCGGATCGGGAACA-1	diploid
GTTCGGGCGTACCATT-1	aneuploid
GTTCGTCTAAAGAACT-1	diploid
GTTGAACCGGTTCCAT-1	aneuploid
GTTGAGTCCCGCCGGT-1	diploid
GTTGCACGGAGTTTCG-1	aneuploid
GTTGCCCTAACGGGTG-1	diploid
GTTGCGGACGGTCAGG-1	diploid
GTTGGATTGAGAACAC-1	aneuploid
GTTGGATTTGCGTTGG-1	aneuploid
GTTGGTCATGCTATCC-1	diploid
GTTGTAGATTTATGAG-1	diploid
GTTGTCGTGTTAGTTG-1	aneuploid
GTTGTTGCAAGATGGC-1	diploid
GTTTACGTTCCATCTG-1	aneuploid
GTTTCCTGGAGGGTGA-1	aneuploid
GTTTCTAGAGGCGCGG-1	diploid
GTTTCTGCAGTCTCCC-1	aneuploid
GTTTGACCAAATCCTA-1	aneuploid
GTTTGGCCCAAGTTAT-1	aneuploid
GTTTGGGCTTGTGAGC-1	aneuploid
GTTTGGGTTTCGCCCG-1	diploid
GTTTGGTAGGGTCAAC-1	diploid
GTTTGTTAGCCAAGTA-1	diploid
TAAACGTCGTCAATGA-1	aneuploid
TAAAGCGGTATTTCCA-1	diploid
TAAAGCGTTAGGAGAA-1	aneuploid
TAAAGCTGCAATAGGG-1	aneuploid
TAAAGTGCACGTCTCG-1	diploid
TAAATCTTTACACCTC-1	diploid
TAAATGAATCCGTTTC-1	aneuploid
TAAATTTAGTAACACC-1	diploid
TAACAAAGGGAGAAGC-1	aneuploid
TAACAATATTTGTTGC-1	aneuploid
TAACATACAATGTGGG-1	aneuploid
TAACATACACGCGATC-1	diploid
TAACCTACCGTCCGAG-1	aneuploid
TAACCTAGGGAGTCCA-1	diploid
TAACGCTTTGAGAGCG-1	aneuploid
TAACTATCGAAGGTCC-1	aneuploid
TAACTATTACGCCAAA-1	aneuploid
TAACTCATCCGCGCGG-1	aneuploid
TAACTCCATGGAGGCT-1	aneuploid
TAACTGAAATACGCCT-1	diploid
TAAGAGGGACAGGGAC-1	diploid
TAAGCAGGCGACACGC-1	aneuploid
TAAGCGCGAATCAAAT-1	diploid
TAAGGAACTTGTGGGA-1	aneuploid
TAAGGCAACATAAGAT-1	aneuploid
TAAGGCTGAATCCCTC-1	aneuploid
TAAGGGCCTGTCCGAT-1	diploid
TAAGGGCTGGGAGAGG-1	aneuploid
TAAGTAACATCTTGAC-1	aneuploid
TAAGTCGCCGAGTATC-1	diploid
TAAGTGAATAGTCTAC-1	diploid
TAAGTTGCGACGTAGG-1	diploid
TAATAAACAAGGAGAT-1	aneuploid
TAATACACAGTAGTAT-1	aneuploid
TAATAGAACAGAGTTA-1	diploid
TAATAGGTCACCAGAA-1	diploid
TAATAGTGACGACCAG-1	aneuploid
TAATATTGAAATTCGC-1	aneuploid
TAATCGATCCGTACGT-1	aneuploid
TAATTACGTCAGTAGA-1	diploid
TAATTAGATGGATATG-1	aneuploid
TAATTAGGACATCCGT-1	diploid
TAATTGCGCTGATTAC-1	diploid
TAATTGGAATCGGGAA-1	aneuploid
TAATTTCCGTCCAGTA-1	diploid
TACAACGCACAACTCA-1	aneuploid
TACAAGGGCTTCTTTA-1	diploid
TACAAGTCTCGTGCAT-1	aneuploid
TACACAGCCGTGGTGC-1	diploid
TACACCGTCGTTAGTC-1	diploid
TACACCTCTTCGAATC-1	diploid
TACAGAAACGGTGGGC-1	diploid
TACATAGGCATACACC-1	aneuploid
TACATCCCTATCCCTG-1	diploid
TACATCTTGTTTCTTG-1	aneuploid
TACATGACCTTATCCG-1	aneuploid
TACATTTCTAACGTGC-1	aneuploid
TACCAAATAGCCCAGA-1	diploid
TACCAATAAAGTACCA-1	diploid
TACCAGAAGTAGGTTC-1	aneuploid
TACCGCGGACTTGCAG-1	aneuploid
TACCGGCTCACTGCCC-1	aneuploid
TACCGTAGGTTAACTA-1	diploid
TACCGTGCCTCGGACC-1	aneuploid
TACCTATCCCTAGAGG-1	diploid
TACCTCACGCTTGTAC-1	aneuploid
TACCTCAGTTGTCTGT-1	diploid
TACCTGCTGCACTGTG-1	aneuploid
TACCTTAAGATTTCCC-1	diploid
TACGAACACGACTTCA-1	aneuploid
TACGACGCTTGCTGCG-1	aneuploid
TACGACTGCCTCTTAG-1	aneuploid
TACGAGAACTTCACGT-1	aneuploid
TACGATGTTGATCATC-1	aneuploid
TACGCAGTTCTTTCCT-1	aneuploid
TACGCCATATTCTAAT-1	aneuploid
TACGCCGAGGGTACCC-1	diploid
TACGCCGCCTCAGAAG-1	diploid
TACGCCTCCATTCCGA-1	diploid
TACGCTATAGAAACCT-1	aneuploid
TACGCTCCTAGAACTG-1	diploid
TACGCTCGGTATTGGA-1	diploid
TACGCTGATAGTTGTA-1	diploid
TACGCTGCTGTGTTAA-1	diploid
TACGGAAGCCAAACCA-1	diploid
TACGGCATGGACGCTA-1	diploid
TACGGGATGCTAGCAG-1	aneuploid
TACGTAAAGCGGAGTG-1	diploid
TACGTACTAGTGCTGA-1	diploid
TACGTGCACTATGCTG-1	aneuploid
TACGTGGGCCCAGGGC-1	diploid
TACGTTTACCGGCAAT-1	aneuploid
TACTACGTGCAATGCG-1	diploid
TACTCGGCACGCCGGG-1	aneuploid
TACTCTCCGAACAAAT-1	aneuploid
TACTGAACAGATTTAG-1	diploid
TACTGAGGGAAGAAAG-1	diploid
TACTGCAATCAATTAC-1	aneuploid
TACTGGACAGCTCGGC-1	aneuploid
TACTGTTTCTCTGGTA-1	diploid
TACTTGTTAGTAGTCC-1	aneuploid
TACTTTACTGAGCCGG-1	aneuploid
TACTTTCCGCACGCCA-1	diploid
TAGAAACACAATAGTG-1	aneuploid
TAGAAATTCACGTATA-1	aneuploid
TAGAACGCCAGTAACG-1	aneuploid
TAGAATAGCCGATGAA-1	diploid
TAGACGAAACGCCAAT-1	diploid
TAGACGCCCGTACCGG-1	aneuploid
TAGACTACCTAGCGTT-1	aneuploid
TAGACTCAGTTGGCCT-1	diploid
TAGAGATCATGCAACT-1	aneuploid
TAGAGCTACGAAGAAC-1	aneuploid
TAGAGGTTCTACTTGT-1	diploid
TAGAGTCTAAGCGAAC-1	aneuploid
TAGATATGGACTGGAA-1	aneuploid
TAGATGGTTCCTTACT-1	diploid
TAGATTCAAAGTGCGG-1	diploid
TAGATTCCTGGTTATT-1	aneuploid
TAGCCAGAGGGTCCGG-1	aneuploid
TAGCCATTTCAAAGTC-1	aneuploid
TAGCCGGCGGTCAGCG-1	aneuploid
TAGCGTCCCTCGATTG-1	diploid
TAGCGTCCGGTGTGGT-1	diploid
TAGCGTCGAATATTGA-1	aneuploid
TAGCGTTGGGTCTTAC-1	aneuploid
TAGCTAAGTCCGGGAG-1	aneuploid
TAGCTAGAAGGCATGA-1	diploid
TAGCTAGTGATGATGG-1	diploid
TAGCTCGCCTGATAAC-1	aneuploid
TAGCTGATGTGAAGCG-1	diploid
TAGGCATGTTACGCCA-1	aneuploid
TAGGCGATGAGGTCTC-1	diploid
TAGGGAGCTTGGGATG-1	aneuploid
TAGGTCCAAGTAAGGA-1	aneuploid
TAGGTCGCCGGAACTG-1	aneuploid
TAGGTGACGATAACCT-1	diploid
TAGGTGAGCCCTACTC-1	aneuploid
TAGGTGCTCGCCTAGC-1	aneuploid
TAGGTTCGAGTTCGTC-1	aneuploid
TAGTACCACAACTTTC-1	diploid
TAGTAGCTTATACCAG-1	diploid
TAGTCCGCAGAGAATG-1	aneuploid
TAGTCCGTATGCATAA-1	aneuploid
TAGTCCTGCACTAAGC-1	diploid
TAGTCGATCACGGGTT-1	diploid
TAGTCGGGATTCTTCG-1	aneuploid
TAGTCTAACAACGAGA-1	aneuploid
TAGTCTGCGGCACATT-1	diploid
TAGTCTGTGACGTTGC-1	aneuploid
TAGTGCCCTCCAGAGT-1	aneuploid
TAGTGTCAGAAACGGC-1	aneuploid
TAGTTTATTCTTGCTT-1	aneuploid
TAGTTTGATCGGTCGC-1	diploid
TATAAATCCACAAGCT-1	aneuploid
TATAAGTGAGGATAGC-1	aneuploid
TATACACAGACGCCTT-1	aneuploid
TATACACGCAAAGTAT-1	aneuploid
TATACCGAGTGCCACA-1	diploid
TATACTCATGCGGCAA-1	aneuploid
TATAGATGGTCGCAGT-1	aneuploid
TATAGCGCACGTTATC-1	diploid
TATAGGGTACTCATGA-1	aneuploid
TATAGTTAGGTGTACT-1	diploid
TATATAGGGCTTTACG-1	diploid
TATATATCGAGAAATG-1	diploid
TATATCATTGATCAGT-1	aneuploid
TATATCCCTGGGAGGA-1	aneuploid
TATATGCTGGGTTGCC-1	aneuploid
TATCAAAGGTCTGTAA-1	aneuploid
TATCACCCAACCGACC-1	aneuploid
TATCACTTCGAGTAAC-1	aneuploid
TATCCAATTGGTTATC-1	diploid
TATCCATATCATGCGA-1	aneuploid
TATCCATCTCGGTTAG-1	diploid
TATCCTATCAACTGGT-1	diploid
TATCCTGCATGGGAAT-1	aneuploid
TATCGATCTATGCATA-1	aneuploid
TATCGATGATTAAACG-1	aneuploid
TATCTACAGAGGTAAT-1	aneuploid
TATCTACCACAGCGGG-1	aneuploid
TATCTAGCCTAAAGGA-1	aneuploid
TATCTGAGCCGATATT-1	diploid
TATCTTGCAATACAAC-1	aneuploid
TATGAAGACAGGTGCG-1	aneuploid
TATGATCCGGCACGCC-1	aneuploid
TATGATCTTCTCTTTA-1	diploid
TATGCTCCCTACTTAC-1	aneuploid
TATGGCCCGGCCTCGC-1	aneuploid
TATGGGACCGAGCAGG-1	aneuploid
TATGGGTACGTATCGT-1	aneuploid
TATGGTCTGAGTAACA-1	aneuploid
TATGGTTAGTGGGAGA-1	aneuploid
TATGTAGAAACCCGGC-1	diploid
TATGTCAAGACCGACT-1	aneuploid
TATGTCTCATTGTGCC-1	aneuploid
TATTACCATCCTGCTT-1	aneuploid
TATTCAATTCTAATCC-1	aneuploid
TATTCCACTCAGCTCG-1	aneuploid
TATTCCGAGCTGTTAT-1	diploid
TATTCCTCCGCCCACT-1	diploid
TATTCGTGCCAGAATA-1	aneuploid
TATTGACATTTCTGCC-1	diploid
TATTTAGTCTAGATCG-1	aneuploid
TATTTATACCGAGTAG-1	aneuploid
TATTTGATTTGCACAG-1	diploid
TCAAACAACCGCGTCG-1	aneuploid
TCAAACTTAGATTGTT-1	aneuploid
TCAAAGTCACGGCGTC-1	diploid
TCAACACATTGGGTAA-1	aneuploid
TCAACATAGCGCCCTA-1	diploid
TCAACATCGACCGAGA-1	diploid
TCAACCATGTTCGGGC-1	aneuploid
TCAACGAGGAGACAAA-1	diploid
TCAACGCAGGAAATAA-1	diploid
TCAACGCGACCGGCAG-1	aneuploid
TCAACTAACGTATAAC-1	aneuploid
TCAAGAAATACTAGCT-1	aneuploid
TCAAGGTTACTACACC-1	diploid
TCAATACAATTGCTGC-1	aneuploid
TCAATACGCCGTCATG-1	diploid
TCACAAACCGAGGTAC-1	diploid
TCACAGATCCTCAAAC-1	aneuploid
TCACAGCAAACTCGAA-1	diploid
TCACAGGGAATCGCAA-1	aneuploid
TCACAGGTTATTGGGC-1	aneuploid
TCACCCTCTTAAGATT-1	aneuploid
TCACCGCTCGGCACTC-1	aneuploid
TCACGCATTGTAGATC-1	aneuploid
TCACGGCCCAAGAGAG-1	diploid
TCACGGTCATCGCACA-1	aneuploid
TCACGTGCCCGATTCA-1	aneuploid
TCACTCGTGCAACGGC-1	aneuploid
TCACTCTTCGTCTGTC-1	aneuploid
TCAGAACCTCCACAGG-1	aneuploid
TCAGACGCTATAGAAG-1	aneuploid
TCAGAGTGTGAGCATG-1	diploid
TCAGCAAATGCATCTC-1	aneuploid
TCAGCAGTAGGCCCTG-1	diploid
TCAGCCAATCCGTAAA-1	diploid
TCAGCTTGAGCTTTCG-1	diploid
TCAGGGCGACTTCCTT-1	aneuploid
TCAGGGCGCAAACTCG-1	aneuploid
TCAGGGTGTAACGTAA-1	aneuploid
TCAGTAGGGACTATAA-1	diploid
TCATAAGTCCAAGAAG-1	diploid
TCATACTTACAGATCC-1	aneuploid
TCATATGAGCTTTGTT-1	diploid
TCATCACTCGAGCTCG-1	aneuploid
TCATCCATCTGATCAC-1	diploid
TCATCCTCAGCTGCTT-1	diploid
TCATGCAGGTTCTCAT-1	aneuploid
TCATTTAAGTCTCCGA-1	aneuploid
TCATTTAGAAGTGTGA-1	diploid
TCCAACTCAGCTATCT-1	diploid
TCCAACTTTAAATTCT-1	aneuploid
TCCAAGCCTAGACACA-1	diploid
TCCAATGCGTCGCCGC-1	diploid
TCCACAATGGTTTACG-1	aneuploid
TCCACATCGTATATTG-1	diploid
TCCACCTCTAGCCTTT-1	diploid
TCCACTTTATCTAGGT-1	aneuploid
TCCAGAGCACCGGTTC-1	aneuploid
TCCAGATGTACGCCAA-1	diploid
TCCAGGCAGGACGATC-1	diploid
TCCAGGCGAGTACGGT-1	aneuploid
TCCATCAATACTAATC-1	diploid
TCCATTAGTTGGATAG-1	aneuploid
TCCCAAACAGACAACG-1	diploid
TCCCAAAGACGAAGGA-1	aneuploid
TCCCACTCTCTTCCGG-1	aneuploid
TCCCAGCACACGACAT-1	diploid
TCCCAGCTTTAGTCTG-1	aneuploid
TCCCGCCTATGTGCGT-1	diploid
TCCCGGGTGTGCTGCT-1	aneuploid
TCCCGGTCAGGAATTT-1	aneuploid
TCCCGTCAGTCCCGCA-1	aneuploid
TCCCGTCGCGTCATAG-1	aneuploid
TCCCGTGTGCAATTTG-1	aneuploid
TCCCTAGATCAATAGG-1	aneuploid
TCCCTGGCGTATTAAC-1	diploid
TCCCTGGCTCGCTGGA-1	aneuploid
TCCCTTAGATTACTCG-1	aneuploid
TCCGAACGTTGCCGCT-1	diploid
TCCGAACTTGGCTTAC-1	aneuploid
TCCGAATGGTCCTGAG-1	aneuploid
TCCGACCGCTAATCAA-1	diploid
TCCGATAATTGCCATA-1	aneuploid
TCCGATGACTGAGCTC-1	aneuploid
TCCGATGGTGCGACAT-1	aneuploid
TCCGATTACATTGCCG-1	aneuploid
TCCGCAGCCACCTAGC-1	aneuploid
TCCGCGGCAGCATCTG-1	aneuploid
TCCGCGGCCCAATGAA-1	diploid
TCCGCTGTCATCCCGG-1	aneuploid
TCCGCTTATCCCATTA-1	aneuploid
TCCGGCCTAGCGTACA-1	aneuploid
TCCGGTTCGTCCGGTC-1	diploid
TCCGTAACCACAATCC-1	aneuploid
TCCGTTAAGCTAATAT-1	diploid
TCCGTTTAGCCTTGAA-1	aneuploid
TCCTAAAGATTCAGAC-1	diploid
TCCTAACCGTCGGGCA-1	diploid
TCCTACATCCACGGCC-1	aneuploid
TCCTAGCAAAGAAGCT-1	aneuploid
TCCTATCATAGGTAAC-1	diploid
TCCTCCTAAGACATTC-1	diploid
TCCTCGGGCTGGGCTT-1	aneuploid
TCCTCTCCAGTTGTCC-1	aneuploid
TCCTGCGTTGATACTC-1	aneuploid
TCCTTACGACGGTCCG-1	diploid
TCCTTCAATCCCTACG-1	diploid
TCCTTCAGTGGTCGAA-1	aneuploid
TCCTTGTCCTTTAATT-1	diploid
TCCTTTAAATCCGCTT-1	diploid
TCCTTTCTTACGCTTA-1	aneuploid
TCGAAATTTAGGACCA-1	aneuploid
TCGAAGAACCGAGCAC-1	aneuploid
TCGAATATCCCGCAGG-1	diploid
TCGACATAGCGTAGCG-1	diploid
TCGAGACCAACACCGT-1	aneuploid
TCGAGCCAGGCAGGCC-1	diploid
TCGAGGGCAACAGACG-1	diploid
TCGCAAAGATGCATTT-1	aneuploid
TCGCACCAGGAGGCAG-1	diploid
TCGCACTAACGTTTGT-1	aneuploid
TCGCATAAAGGGCGCA-1	diploid
TCGCATCCCTAAGTGT-1	aneuploid
TCGCATTCAATGACTT-1	aneuploid
TCGCCACCCGGATTAC-1	diploid
TCGCCCACTGCGAGAG-1	aneuploid
TCGCCGAAGTTGCGTC-1	aneuploid
TCGCCGCACCGCGTGA-1	diploid
TCGCCGGATGGGCAAG-1	aneuploid
TCGCCGGTCGATCCGT-1	aneuploid
TCGCCTCGACCTGTTG-1	aneuploid
TCGCGCGTTTACATGA-1	diploid
TCGCGTCCAGAAGGTC-1	aneuploid
TCGCTAAACCGCTATC-1	aneuploid
TCGCTCGATATATTCC-1	aneuploid
TCGCTCGGCACCAGCG-1	aneuploid
TCGCTGGGCGGATTGT-1	aneuploid
TCGCTGTGCGTAAATC-1	aneuploid
TCGCTTTAAACGTTTG-1	aneuploid
TCGGAATGCGCTCTGA-1	aneuploid
TCGGACGCCCAGCCCA-1	aneuploid
TCGGAGAGTATCGGGA-1	diploid
TCGGAGTACATGAGTA-1	aneuploid
TCGGATCTGGATGACC-1	diploid
TCGGCGAACCCAAACC-1	diploid
TCGGCGTACTGCACAA-1	diploid
TCGGGAACGTGCCTAG-1	aneuploid
TCGGGATTCAAACATA-1	aneuploid
TCGGGCCGTCGTGGTA-1	aneuploid
TCGTAAGACGACATTG-1	aneuploid
TCGTACCGACGTCAAG-1	diploid
TCGTATTACCCATTGC-1	aneuploid
TCGTCAAGTACGCGCA-1	diploid
TCGTCACACTGTTAGC-1	aneuploid
TCGTCCGCTGGCGTCT-1	diploid
TCGTCTTAGGCGTTAA-1	diploid
TCGTTAGGAGTCCCTA-1	diploid
TCGTTGACAGGGTCCC-1	aneuploid
TCGTTGGCTCGTCAAT-1	aneuploid
TCGTTTACGCGACCCT-1	diploid
TCTAAAGAACAGTCTC-1	diploid
TCTAACTGTATGTAAA-1	aneuploid
TCTACCGTCCACAAGC-1	aneuploid
TCTAGCAATCTCCGCC-1	diploid
TCTAGCATCTTCGATG-1	aneuploid
TCTAGCATGCCCAGAA-1	aneuploid
TCTAGGTGGCGACGCT-1	aneuploid
TCTAGTGATATCGTGG-1	aneuploid
TCTAGTTATCAGAAGA-1	diploid
TCTATAGGTGGGTAAT-1	diploid
TCTATCATGCAGTTAC-1	aneuploid
TCTATCGGTCGCAACA-1	aneuploid
TCTATGCTATAACGAC-1	diploid
TCTATTACGCTGGCGA-1	aneuploid
TCTATTACTAGAGGAT-1	diploid
TCTCAAATCAATCGGG-1	diploid
TCTCATGAGATAGGGT-1	aneuploid
TCTCCAACGTAGGTTA-1	aneuploid
TCTCCACAAGTTGAAT-1	diploid
TCTCCCTGGGCAGCGT-1	diploid
TCTCGACGTATCGCCG-1	diploid
TCTCGGCTCCAGGACT-1	aneuploid
TCTCGTGTTACGAGGA-1	aneuploid
TCTCTAATAGCTGGTA-1	aneuploid
TCTCTCGCCGCACATA-1	diploid
TCTGAACCGGTCGGCT-1	aneuploid
TCTGAACTCGTACCCG-1	aneuploid
TCTGAATTCCGTACAA-1	aneuploid
TCTGACGGGCTAACCC-1	diploid
TCTGATGTATTCTGTC-1	diploid
TCTGATTGGAAATGGA-1	diploid
TCTGCAGATTCGAGTC-1	aneuploid
TCTGCATACCTTGCTT-1	diploid
TCTGCCAGAAACTGCA-1	aneuploid
TCTGCGTCCGGTTTCT-1	aneuploid
TCTGCTTAGAACAAGC-1	diploid
TCTGGAGCGTAAGAGT-1	diploid
TCTGGCGCAAGCCGGG-1	aneuploid
TCTGGGAACCTTTGAA-1	aneuploid
TCTGGGTAGCGCTCAT-1	aneuploid
TCTGTCATACAAGAGC-1	aneuploid
TCTGTGCCATCATAGT-1	aneuploid
TCTTAACTCGGATGTA-1	aneuploid
TCTTACAGAGGTACCG-1	aneuploid
TCTTACCGGAACTCGT-1	aneuploid
TCTTACGGCATCCGAC-1	aneuploid
TCTTACTTATGCCTCT-1	aneuploid
TCTTAGAGCTCCAATT-1	diploid
TCTTAGAGTGAACTCT-1	aneuploid
TCTTCCCATGGGCACA-1	aneuploid
TCTTCGAATAGACGTT-1	aneuploid
TCTTCGATACCAATAA-1	aneuploid
TCTTCGCGGTGAGAGG-1	diploid
TCTTCTATAACCCGCC-1	diploid
TCTTGATGCGTAGCGA-1	aneuploid
TCTTGGTAACACCAAA-1	aneuploid
TCTTGGTCAATGATAC-1	diploid
TCTTTAAGACTATGAA-1	aneuploid
TCTTTAGCAGGCGAAC-1	diploid
TGAAAGGACCTGACTC-1	aneuploid
TGAAGAGCGGTCCTAG-1	aneuploid
TGAAGTAGCTTACGGA-1	aneuploid
TGAATTTCACTTGCCT-1	diploid
TGACAACGCATGTCGC-1	diploid
TGACAGGACAAGTCCA-1	diploid
TGACATATATGACGAT-1	aneuploid
TGACATCGAGCGGACC-1	aneuploid
TGACATGTAACGTGAC-1	diploid
TGACCAAATCTTAAAC-1	diploid
TGACCCACGTTAGACA-1	aneuploid
TGACGAATATTTCCCT-1	aneuploid
TGACGATGCACTAGAA-1	aneuploid
TGACTATAATCCTTTC-1	aneuploid
TGACTCCGAATCATAC-1	diploid
TGAGAATGCTTTACCG-1	aneuploid
TGAGACGTACCTCTCA-1	aneuploid
TGAGAGATTTACCACG-1	aneuploid
TGAGATTAGGCCCTAA-1	aneuploid
TGAGCCATACAGTCTC-1	aneuploid
TGAGCGGAAAGTGTTC-1	diploid
TGAGCTTTAATGACGC-1	aneuploid
TGAGGCATGTACTGTG-1	diploid
TGAGTAAATTAGCGTA-1	aneuploid
TGAGTGCCTCTTAAAT-1	aneuploid
TGAGTGGTCCGTGACG-1	aneuploid
TGAGTTAAAGACATTC-1	diploid
TGATACATTTAGCCGT-1	diploid
TGATAGCGGGATTCTA-1	aneuploid
TGATCAGGGAACTGCT-1	aneuploid
TGATCCCAGCATTAGT-1	aneuploid
TGATCGGTTTGACCCT-1	aneuploid
TGATCTACGCTGATCT-1	aneuploid
TGATCTCCGGCGCCAG-1	aneuploid
TGATGGCTGTTTCTGA-1	aneuploid
TGATGGGACTAAGTCA-1	aneuploid
TGATTCAGGTCCCGCG-1	diploid
TGATTCCCGGTTACCT-1	diploid
TGATTCGTCTATCACT-1	aneuploid
TGATTCTGTCGCCGGT-1	diploid
TGATTTATTAGCTGTG-1	aneuploid
TGATTTCCTCCTGACG-1	aneuploid
TGCAAAGTTCGTCTGT-1	diploid
TGCAACCCATCTGCGG-1	diploid
TGCAAGAATGACGTAA-1	aneuploid
TGCAATCTAACACGGT-1	diploid
TGCACTATGTGAGTGC-1	aneuploid
TGCAGAACTATATCGT-1	aneuploid
TGCAGAGTACCGAGCA-1	aneuploid
TGCAGATCGTCCTAGG-1	aneuploid
TGCAGCTACGTACTTC-1	diploid
TGCAGGATCGGCAAAG-1	aneuploid
TGCAGTGGTAGGGAAC-1	diploid
TGCAGTTTCCTCCCAT-1	aneuploid
TGCATATGTCTGTCAC-1	aneuploid
TGCATGTGGTAATCTA-1	aneuploid
TGCCAAAGTCAGACTT-1	aneuploid
TGCCAATGGGTACTCT-1	diploid
TGCCACACTAGAGGAA-1	diploid
TGCCACCTGGCGAAAC-1	aneuploid
TGCCAGTACGTGGAGA-1	aneuploid
TGCCATTACTAAAGAA-1	aneuploid
TGCCCGATAGTTAGAA-1	diploid
TGCCCGTACCGTTAAA-1	aneuploid
TGCCGAAAGCGTATTC-1	aneuploid
TGCCGTGGATCGTCCT-1	diploid
TGCCGTGGGACCCAAT-1	diploid
TGCCGTTCTTAATCGG-1	diploid
TGCCTAATTGAAGATT-1	diploid
TGCCTGACATCGGTCA-1	aneuploid
TGCCTGATCAAACGAT-1	aneuploid
TGCCTTGGCCAGGCAA-1	diploid
TGCGAATATGGGATTT-1	diploid
TGCGACACCCTAGTGC-1	aneuploid
TGCGAGAAACGTTACG-1	aneuploid
TGCGAGAATATTACCC-1	diploid
TGCGATGCTAATGGCT-1	aneuploid
TGCGCAAAGCATTTGG-1	aneuploid
TGCGCGATTAACGGAG-1	aneuploid
TGCGGAGTAAAGGTGC-1	aneuploid
TGCGGCATAGTTCAAC-1	aneuploid
TGCGGTGAAATTTCAT-1	aneuploid
TGCGTAAGAACCTGAT-1	aneuploid
TGCGTGATTGGGTGTC-1	aneuploid
TGCGTTTGTTGACACT-1	aneuploid
TGCTAAGTGTCTATTT-1	diploid
TGCTCCACAGTTCTTA-1	aneuploid
TGCTGGTTGGACAATT-1	aneuploid
TGCTGTTGAAGAACTC-1	aneuploid
TGCTTAGAGAGAATGC-1	diploid
TGGAAACGGAGTGAAC-1	aneuploid
TGGAACCACTGACACA-1	aneuploid
TGGAAGAAGGGAACGT-1	diploid
TGGAAGGATAAAGATG-1	aneuploid
TGGAATATCCTTGACC-1	aneuploid
TGGAATTAGACGCTTT-1	aneuploid
TGGACACCGTTGCTTG-1	aneuploid
TGGACCAATCTAAGAT-1	diploid
TGGACCACGGCGTTGA-1	aneuploid
TGGACGCAATCCAGCC-1	diploid
TGGACTGTTCGCTCAA-1	aneuploid
TGGAGAATAATCGTCC-1	diploid
TGGAGCTAAAGTTCCC-1	aneuploid
TGGAGTGATGCGATGA-1	aneuploid
TGGATAGAGTAACAGA-1	aneuploid
TGGCAAACTAAATTAC-1	aneuploid
TGGCAACTCGCGCGCC-1	aneuploid
TGGCAAGCACAAGTCG-1	diploid
TGGCAGATTACGATCA-1	aneuploid
TGGCAGCAGTAATAGT-1	aneuploid
TGGCATGAAGTTTGGG-1	diploid
TGGCCAAACTGAAGTA-1	aneuploid
TGGCCGTATATTGACC-1	aneuploid
TGGCGACTGCTCCAAA-1	diploid
TGGCGATCAAGTTATG-1	diploid
TGGCTACACTCTACCT-1	diploid
TGGCTCTTGTCGCGTA-1	diploid
TGGCTTTGGGTAGACA-1	aneuploid
TGGGAAATGCCTTTCC-1	aneuploid
TGGGACCATTGGGAGT-1	aneuploid
TGGGCAATAGTTGGGT-1	diploid
TGGGCACGTTCTATGG-1	aneuploid
TGGGCCACAAGAGCGC-1	aneuploid
TGGGCCCATACTAATT-1	aneuploid
TGGGCGATACAATAAG-1	diploid
TGGGTGTAATAGATTT-1	diploid
TGGGTGTTAAGTAGAA-1	diploid
TGGGTTCCCGGACGGA-1	aneuploid
TGGTAAGCAGGATTGA-1	diploid
TGGTAGAATATATGGG-1	diploid
TGGTCCCACGCTACGG-1	diploid
TGGTCGATATACCTCT-1	diploid
TGGTCGTGCAAGGCAA-1	diploid
TGGTCTAGCTTACATG-1	aneuploid
TGGTCTGTTGGGCGTA-1	aneuploid
TGGTGATCGTATTTGT-1	aneuploid
TGGTGCCCTGCCTTAC-1	diploid
TGGTTAAGGGCGCTGG-1	diploid
TGGTTATGCTTGCGGT-1	aneuploid
TGGTTCAACGGGTAAT-1	aneuploid
TGGTTCGTAGCAAAGG-1	aneuploid
TGGTTTAAACGTGGGT-1	diploid
TGTAATGACCACAATA-1	aneuploid
TGTACCCGACCCTAAT-1	diploid
TGTACCTACACGAGGG-1	diploid
TGTACGAACAAATCCG-1	aneuploid
TGTAGCCAATTCCGTT-1	diploid
TGTAGGAGAAATTTCC-1	aneuploid
TGTAGTGATCTATAAT-1	aneuploid
TGTATAACAGATCCTG-1	aneuploid
TGTATCCTTATTCCAT-1	aneuploid
TGTATGGCGCAGACAG-1	aneuploid
TGTCCCGACATAGCAC-1	aneuploid
TGTCCGCAAACAATTC-1	diploid
TGTCCGTGGCGCCTTT-1	aneuploid
TGTCCTAAGTCACCGC-1	aneuploid
TGTCGTTATCACATAT-1	diploid
TGTCTACAGTTTCTGT-1	aneuploid
TGTGACTACGCCAGTC-1	aneuploid
TGTGAGACTAGCCCAA-1	diploid
TGTGCCGGTGCCGGAA-1	diploid
TGTGCTTTACGTAAGA-1	aneuploid
TGTGGACTATCTACGT-1	diploid
TGTGGCAAAGCGTATG-1	aneuploid
TGTGGCGGGCTTCTGG-1	diploid
TGTGGCTCCCACCAAC-1	diploid
TGTGGTAGGGTGCCTT-1	diploid
TGTGGTTGCTAAAGCT-1	diploid
TGTGTCGAAGTCGAGG-1	diploid
TGTGTCGCGAGTTGCA-1	aneuploid
TGTGTTCGTATCCAAG-1	aneuploid
TGTTATTGTATGTGGC-1	aneuploid
TGTTCATAAATGTGCT-1	aneuploid
TGTTCCGCTTCCATGA-1	aneuploid
TGTTCCGGCCTGAGCT-1	diploid
TGTTCGTATTGCGGTG-1	aneuploid
TGTTCTTCCATTGACT-1	aneuploid
TGTTGCCGTCGTCCCA-1	diploid
TGTTGTCAAGAAGTCT-1	aneuploid
TGTTTCGGTACTTCTC-1	aneuploid
TGTTTGAGATCGTCAG-1	diploid
TTAAACAGAGTCCCGC-1	aneuploid
TTAAACCTGGTTCCTT-1	aneuploid
TTAAACTCGAATTCAT-1	aneuploid
TTAAAGGCGATGCTCG-1	diploid
TTAACCAACCCTCCCT-1	aneuploid
TTAACGAACAAGCAGT-1	diploid
TTAACGTTAAAGCCTG-1	aneuploid
TTAACTCACGCGTGGA-1	aneuploid
TTAACTTCAGGTAGGA-1	aneuploid
TTAAGATACCCAGAGA-1	diploid
TTAAGATAGGATTGAC-1	aneuploid
TTAAGCGCCTGACCCA-1	aneuploid
TTAATCAGTACGTCAG-1	aneuploid
TTAATGTAGACCAGGT-1	aneuploid
TTAATGTGTTTGCAGG-1	aneuploid
TTAATTGCTTTGGGTG-1	diploid
TTAATTTCAGACGCGG-1	aneuploid
TTACAACTACGCATCC-1	aneuploid
TTACACGATCTGCGAC-1	diploid
TTACAGACCTAAATGA-1	aneuploid
TTACATCGTGGCCTGG-1	aneuploid
TTACATGCCACAACTA-1	aneuploid
TTACCATTGATTACCC-1	aneuploid
TTACCCATTGCCGGGT-1	aneuploid
TTACCCTAACAGTCCT-1	aneuploid
TTACCCTAGGGATTGG-1	diploid
TTACCGCCTTAGGGAA-1	aneuploid
TTACGGATGGTTCGAG-1	aneuploid
TTACTAAAGGACTTTA-1	aneuploid
TTACTATCGGCTTCTC-1	aneuploid
TTACTCCGGCCGGGAA-1	aneuploid
TTACTCTGGTACGTAC-1	aneuploid
TTACTGGGATATTTCA-1	aneuploid
TTAGAAGAACATGACT-1	aneuploid
TTAGAATAAGGGTCGG-1	diploid
TTAGACGAGTCACCTC-1	aneuploid
TTAGAGTTTAGAAGGA-1	aneuploid
TTAGATAGGTCGATAC-1	aneuploid
TTAGCTAATACGATCT-1	aneuploid
TTAGCTCTGTAATCCG-1	aneuploid
TTAGCTGATTTGCCGT-1	aneuploid
TTAGGTCATAACCGAC-1	diploid
TTAGTAGGGCGGCGGG-1	aneuploid
TTAGTTATTCGTGGCA-1	aneuploid
TTAGTTCAAGTGTTCG-1	diploid
TTATAGGTAATTGTCT-1	diploid
TTATATACGCTGTCAC-1	aneuploid
TTATCCAATCGAACTC-1	aneuploid
TTATCCTCAAGGAATA-1	diploid
TTATCGCCTGCGAAGC-1	aneuploid
TTATCTGACATTAGGA-1	diploid
TTATCTGTATCATAAC-1	aneuploid
TTATGAATGAAAGGGA-1	aneuploid
TTATGACAAACTGGAT-1	aneuploid
TTATGATCTTAACGAA-1	aneuploid
TTATGTTTGCGATAGA-1	aneuploid
TTATTAGAGCGTGTTC-1	aneuploid
TTATTAGGGAAGCATC-1	aneuploid
TTATTATCTGGAAGGC-1	diploid
TTCAAAGTCTCTAGCC-1	aneuploid
TTCAACGACCCGACCG-1	aneuploid
TTCAATACTCTGAATC-1	aneuploid
TTCACGGTCGTCACGT-1	diploid
TTCACTTCCTAGAACG-1	diploid
TTCAGAGTAACCTGAC-1	aneuploid
TTCAGCCCTGGTCCAC-1	aneuploid
TTCAGCTGGCGTGCCC-1	diploid
TTCAGGCGTCAAAGCC-1	aneuploid
TTCAGTTCAAGAGGAG-1	diploid
TTCATAGCCTTGTAAC-1	aneuploid
TTCATGGCGCAACAGG-1	aneuploid
TTCCAATCAGAGCTAG-1	aneuploid
TTCCAATCTGGCTATC-1	aneuploid
TTCCACACAGATTTGA-1	aneuploid
TTCCAGACGAGATTTA-1	diploid
TTCCATCGACAGCGTG-1	diploid
TTCCCGGCGCCAATAG-1	diploid
TTCCGCAGAGAAATAT-1	aneuploid
TTCCGCGTGAGGCGAT-1	aneuploid
TTCCGGCCTTGAGGCT-1	diploid
TTCCGGTTACCCACTT-1	diploid
TTCCTCGAGGGTGTCT-1	aneuploid
TTCCTCGGACTAACCA-1	aneuploid
TTCCTCTGCCCGAATA-1	aneuploid
TTCGAACGAAACATGC-1	diploid
TTCGACAGAGCCCGTG-1	diploid
TTCGCACTCGCGTGCT-1	aneuploid
TTCGCACTGTACGACA-1	diploid
TTCGCATCCGGAAGCA-1	aneuploid
TTCGCCGCTCGCGCTA-1	diploid
TTCGCGCGCCATACGA-1	diploid
TTCGCTAGGAAGTTGT-1	diploid
TTCGCTATCTGACGTG-1	aneuploid
TTCGGACTGGGCATGG-1	diploid
TTCGGCTAGAGATGGT-1	aneuploid
TTCGGGACTAATCGCG-1	aneuploid
TTCGGGCGCTAGTCTT-1	diploid
TTCGGTACTGTAGAGG-1	diploid
TTCGGTGGAGACGCCC-1	diploid
TTCGTACTCCAGAACG-1	aneuploid
TTCGTTCAACGAAGTT-1	aneuploid
TTCTAACCGAAGCTTA-1	aneuploid
TTCTACCTCAATCGGT-1	diploid
TTCTACTTGCGAGGGC-1	aneuploid
TTCTAGAAAGTCTTAT-1	diploid
TTCTAGGCCAATTGTG-1	aneuploid
TTCTCAATTGCTACAA-1	diploid
TTCTGACCGGGCTCAA-1	diploid
TTCTGCCGCGCCTAGA-1	aneuploid
TTCTGCGAGCGCCCTT-1	aneuploid
TTCTGCGGGTTAGCGG-1	aneuploid
TTCTGCTAGACTCCAA-1	aneuploid
TTCTGTTTCCTGTCGC-1	aneuploid
TTCTTAGTGAACGGTG-1	aneuploid
TTCTTAGTGGCTCAGA-1	aneuploid
TTCTTATCCGCTGGGT-1	diploid
TTCTTGAGCCGCGCTA-1	aneuploid
TTCTTGCTAGCATCTC-1	diploid
TTCTTGGAGTAATGAG-1	aneuploid
TTCTTGTAACCTAATG-1	aneuploid
TTCTTGTGTCCATCAG-1	aneuploid
TTGAACGAATCCTTTG-1	aneuploid
TTGAAGGATGGGCGCC-1	diploid
TTGAATATGGACTTTC-1	aneuploid
TTGAATCGTTGTATAA-1	diploid
TTGAATTCACGTGAGG-1	aneuploid
TTGACAGGAGCTCCCG-1	diploid
TTGACATGAACGTGGA-1	diploid
TTGACCAGGAACAACT-1	diploid
TTGACCATGTTCTCCG-1	aneuploid
TTGACCGTGTTAATGA-1	diploid
TTGACGCTCCATGAGC-1	aneuploid
TTGACTACCATATGGT-1	aneuploid
TTGACTATTGTCCGGC-1	diploid
TTGAGAAGTTTAGCAT-1	diploid
TTGAGAGTACTGCTAA-1	aneuploid
TTGAGCAGCCCACGGT-1	diploid
TTGATAGTCAATACAT-1	aneuploid
TTGATCTAACTTTGTC-1	aneuploid
TTGATGTGTAGTCCCG-1	aneuploid
TTGATTATGCAGATGA-1	aneuploid
TTGCAAGAAGACTCCT-1	diploid
TTGCACAATTCAGAAA-1	aneuploid
TTGCACGGAGCAGCAC-1	aneuploid
TTGCATGCTGATCACG-1	aneuploid
TTGCCAAGCAGAACCC-1	diploid
TTGCCATAGCCCGCTC-1	diploid
TTGCCCTGATCACGGG-1	aneuploid
TTGCCGCTTTCTAGTA-1	diploid
TTGCCTAATCCAAAGT-1	diploid
TTGCGCTCTCTCGCTT-1	aneuploid
TTGCGGCATCAGAAAG-1	diploid
TTGCGTCGGCCAACCG-1	diploid
TTGCGTGAACGCTTAG-1	aneuploid
TTGCTCCCATACCGGA-1	aneuploid
TTGCTGAAGGAACCAC-1	aneuploid
TTGCTGATCATGTTCG-1	aneuploid
TTGCTGCACCTATCCA-1	aneuploid
TTGGAAGAATACAGTC-1	diploid
TTGGACATGTGGCTTA-1	diploid
TTGGACCATCTGGCAA-1	diploid
TTGGACCTATAACAGT-1	diploid
TTGGATATCGTCTACG-1	aneuploid
TTGGATTGGGTACCAC-1	aneuploid
TTGGCCATCTTGCGCT-1	aneuploid
TTGGCCTAGAATTTCG-1	aneuploid
TTGGCTCAATATGTGT-1	diploid
TTGGCTCGCATGAGAC-1	aneuploid
TTGGGAAGACGAGCCG-1	diploid
TTGGGCGGCGGTTGCC-1	aneuploid
TTGGTATGGCTTGTGT-1	diploid
TTGGTCACACTCGTAA-1	aneuploid
TTGGTTGCGGTGCGCG-1	diploid
TTGTAAGGACCTAAGT-1	diploid
TTGTAAGGCCAGTTGG-1	aneuploid
TTGTAATCCGTACTCG-1	aneuploid
TTGTCACCGCGGTATC-1	diploid
TTGTCGTTCAGTTACC-1	aneuploid
TTGTGAACCTAATCCG-1	diploid
TTGTGAGGCATGACGC-1	diploid
TTGTGCAGCCACGTCA-1	diploid
TTGTGCGGAAGCGGAT-1	diploid
TTGTGGCCCTGACAGT-1	aneuploid
TTGTGGTAGGAGGGAT-1	diploid
TTGTGTATGCCACCAA-1	diploid
TTGTGTTTCCCGAAAG-1	aneuploid
TTGTTAGCAAATTCGA-1	aneuploid
TTGTTCTAGATACGCT-1	aneuploid
TTGTTGTGTGTCAAGA-1	aneuploid
TTGTTTCACATCCAGG-1	diploid
TTGTTTCATTAGTCTA-1	diploid
TTGTTTCCATACAACT-1	aneuploid
TTGTTTGTATTACACG-1	diploid
AAACAGGGTCTATATT-1	not.defined
AAACATGGTGAGAGGA-1	not.defined
AAACATTTCCCGGATT-1	not.defined
AAACCGGAAATGTTAA-1	not.defined
AAACGAAGATGGAGTA-1	not.defined
AAACTCGGTTCGCAAT-1	not.defined
AAAGGCTACGGACCAT-1	not.defined
AAAGGCTCTCGCGCCG-1	not.defined
AAATCCGATACACGCC-1	not.defined
AAATGGCCCGTGCCCT-1	not.defined
AACATTGAAGTTGATC-1	not.defined
AACCCGAGCAGAATCG-1	not.defined
AACCTGTCACGGAATT-1	not.defined
AACGAAAGTCGTCCCA-1	not.defined
AACGCGACCTTGGGCG-1	not.defined
AACGCGGTCTCCAGCC-1	not.defined
AACTGAGTTATACTGA-1	not.defined
AAGAGGCCCTTTGGAA-1	not.defined
AAGCACCCTGCGTATC-1	not.defined
AAGCCACTTGCAGGTA-1	not.defined
AAGCCGGAGAGCAGGA-1	not.defined
AAGCGTCCCTCATCGA-1	not.defined
AAGCTCTTTCATGGTG-1	not.defined
AAGTTTATGGGCCCAA-1	not.defined
AATACCGGAGGGCTGT-1	not.defined
AATAGCTACCGCGTGC-1	not.defined
AATAGTCCGTCCCGAC-1	not.defined
AATATCCTAGCAAACT-1	not.defined
AATGTGCTAATCTGAG-1	not.defined
AATTCATTGTCATGCA-1	not.defined
AATTGCAGCAATCGAC-1	not.defined
ACAAACCATGCGTCCT-1	not.defined
ACAAAGCATGACCTAG-1	not.defined
ACAAGGATGCTTTAGG-1	not.defined
ACAATTTGGCCATATT-1	not.defined
ACACGGGAACTTAGGG-1	not.defined
ACACTCCAATGTCACT-1	not.defined
ACACTGGGACAGTCGT-1	not.defined
ACATAAGTCGTGGTGA-1	not.defined
ACATCCCGGCCATACG-1	not.defined
ACCAACGCTTATTTAT-1	not.defined
ACCAGACCATAACAAC-1	not.defined
ACCCATTTGTCCCTCT-1	not.defined
ACCGACACATCTCCCA-1	not.defined
ACCGATAGGCATAACC-1	not.defined
ACCGATATTTAATCAT-1	not.defined
ACCGCTAGTCATTGGT-1	not.defined
ACCTCCGCCCTCGCTG-1	not.defined
ACCTCGAACTTATGCT-1	not.defined
ACGACTGGTCATACTC-1	not.defined
ACGAGGTTTACAACGT-1	not.defined
ACGCATACGTTTACTA-1	not.defined
ACGGATGGTGCGGATA-1	not.defined
ACGTACTTTGGCACGG-1	not.defined
ACGTCGGGCAACTCGG-1	not.defined
ACGTTCTGTACAAGTC-1	not.defined
ACTACCAGCTCTCTGG-1	not.defined
ACTATCTGCCCGCGTA-1	not.defined
ACTCCAATATCATCAT-1	not.defined
ACTCCCTAATGCTAAA-1	not.defined
ACTCGCGATCTGACGC-1	not.defined
ACTCGTAACCCGTCCT-1	not.defined
ACTCTTCAGCTCCCGC-1	not.defined
ACTGCCCGCCATTCTC-1	not.defined
ACTGCGGACACACCGT-1	not.defined
ACTTGTGGATGGAACG-1	not.defined
AGAAATTATGACTCGC-1	not.defined
AGAAGAGCGCCGTTCC-1	not.defined
AGAAGGTTGTAGGTCG-1	not.defined
AGAAGTGATTCGTGAT-1	not.defined
AGACGCCCACTTCGCC-1	not.defined
AGAGAAACACCAGAAA-1	not.defined
AGAGAAGGAGTACAAT-1	not.defined
AGAGCCGCCGAGATTT-1	not.defined
AGAGTATAGTGTTACG-1	not.defined
AGATACCAATAGAACC-1	not.defined
AGATATAATACGACTA-1	not.defined
AGCACCAGTACTCACG-1	not.defined
AGCAGAAGGAGAAAGA-1	not.defined
AGCCCGCAACAAGCAG-1	not.defined
AGCCCTCCCTGGTGGC-1	not.defined
AGCCCTGTCGCACCGT-1	not.defined
AGCCTAATACCCACGT-1	not.defined
AGCGAGACGTGAAGGC-1	not.defined
AGCGATGCGCCTAATA-1	not.defined
AGCGGGTCTGACACTC-1	not.defined
AGCTAACAAGCAATGT-1	not.defined
AGCTCCATATATGTTC-1	not.defined
AGCTTCTTCTCGAGCA-1	not.defined
AGGAAGCTGTCCGCCG-1	not.defined
AGGACATCGCACGTCG-1	not.defined
AGGCACGTGACTGTCC-1	not.defined
AGGCCACATTGGTTAC-1	not.defined
AGGCCTGAGAATCTCG-1	not.defined
AGGCGATAACTGGCGT-1	not.defined
AGGCGGTTTGTCCCGC-1	not.defined
AGGGACTCTACGCGAC-1	not.defined
AGGGTGCCGTTCTTTA-1	not.defined
AGGTAGATCGAGATAT-1	not.defined
AGGTATGCGGACATTA-1	not.defined
AGGTCAGGTGAGAGTG-1	not.defined
AGGTCGCCTCCCAACA-1	not.defined
AGGTGGTGACCTTCGC-1	not.defined
AGTAGGAAGGAAGTTG-1	not.defined
AGTATGCTGGAGACCA-1	not.defined
AGTATTTGGCACGACC-1	not.defined
AGTCAAATGATGTGAT-1	not.defined
AGTCACTAGCTCTCGA-1	not.defined
AGTCGAAACGATTCAG-1	not.defined
AGTCGTCGACCACCAA-1	not.defined
AGTCGTGGGCATTACG-1	not.defined
AGTCTTCTCCTCAAAT-1	not.defined
AGTCTTTAAAGTGTCC-1	not.defined
AGTGACTGTGACACAA-1	not.defined
AGTGATAACCTGCGCG-1	not.defined
AGTTAAGCGGTCCCGG-1	not.defined
AGTTACCGCACATGGT-1	not.defined
AGTTCACCGGTTGGAC-1	not.defined
AGTTCCTATTTATGTT-1	not.defined
ATAAACGTTGCACCAC-1	not.defined
ATAATTAGCTAAGTAG-1	not.defined
ATACGAAGGCTTTCCA-1	not.defined
ATACTACCCGTACCAC-1	not.defined
ATATAACACGGGCGCA-1	not.defined
ATATACGCTCGTGACG-1	not.defined
ATATAGAGTATTGGTC-1	not.defined
ATATCTTAGGGCCTTC-1	not.defined
ATATTGGAGAGGCCTT-1	not.defined
ATCATAGCCCTATGTA-1	not.defined
ATCATTGTACCGCATT-1	not.defined
ATCCACATCGACAGAA-1	not.defined
ATCCCATCCACAGCGC-1	not.defined
ATCGCTTTACGTCTCA-1	not.defined
ATCTAGCTTGTGAGGG-1	not.defined
ATCTCCCACGGAATAT-1	not.defined
ATCTTATCGCACACCC-1	not.defined
ATGAGGAGTGTTAATC-1	not.defined
ATGCATGATCCAGGAT-1	not.defined
ATGCTCAGTGTTGCAT-1	not.defined
ATGCTTAGGAGTTGAT-1	not.defined
ATGGAACCTTTGCACA-1	not.defined
ATGGTATTTACTGATT-1	not.defined
ATGTACATGCGGTGAG-1	not.defined
ATGTACGATGACGTCG-1	not.defined
ATGTTGATTAGAGACT-1	not.defined
ATGTTGTAGTCTGTTT-1	not.defined
ATTAATTCGGTCACTC-1	not.defined
ATTATGAGACCCAATT-1	not.defined
ATTATTATGTCCGTCA-1	not.defined
ATTATTCAGAGTCACT-1	not.defined
ATTCGCGCCTTGAGAG-1	not.defined
ATTGAAGATCTTAGTG-1	not.defined
ATTGACCGGCGATGAC-1	not.defined
ATTGCCTATTAGACCG-1	not.defined
ATTGCTGCTCCTCCAT-1	not.defined
ATTGGATTACAGCGTA-1	not.defined
ATTGTTCAACGATCCG-1	not.defined
CAAACTCGCGACGCCG-1	not.defined
CAACCAGTGGCCTACC-1	not.defined
CAACCGCACCTAGACA-1	not.defined
CAAGGCCAGTGGTGCA-1	not.defined
CAATACGAGAGTCTGA-1	not.defined
CAATGCGAGAAGTATC-1	not.defined
CACAAGCTAAGAAAGG-1	not.defined
CACACACGCTAACGAG-1	not.defined
CACAGAGACGAGGACG-1	not.defined
CACAGTCCCGCTTCGC-1	not.defined
CACAGTTCGCTTCCCA-1	not.defined
CACATCTCACCGACGA-1	not.defined
CACCCACGAGGCAATT-1	not.defined
CACCCGGTTTGTGACT-1	not.defined
CACCTCGATGGTGGAC-1	not.defined
CACGGCGCGCCAAAGG-1	not.defined
CACGGGATTGAGGGTT-1	not.defined
CACGTCGGGTTCTAGA-1	not.defined
CACTCTCAAGCATCGA-1	not.defined
CACTGACGATTGTGGA-1	not.defined
CAGAATATTCGTTATC-1	not.defined
CAGCCTCTCCTCAAGA-1	not.defined
CAGCTCGTGCTTGTGT-1	not.defined
CAGCTGGCGTAACCGT-1	not.defined
CAGGACAGCTGCCCTT-1	not.defined
CAGGCAGTCTTACCAG-1	not.defined
CAGGCGCACGGTGGTC-1	not.defined
CAGGGAGATAGGCCAG-1	not.defined
CAGTAAGGGACGTCTC-1	not.defined
CAGTCGGCCTAGATAT-1	not.defined
CAGTCTCTCGGCTAAT-1	not.defined
CATACGAACTAGCTGG-1	not.defined
CATCCAATATAGTTTG-1	not.defined
CATGAGATGCACTCTC-1	not.defined
CATGATGGAAGTTAGC-1	not.defined
CATGGATTGTCTTCCG-1	not.defined
CATGGCTCCCTATGTC-1	not.defined
CATGGGTATGCCTTAT-1	not.defined
CATGGTATTAGTTTGT-1	not.defined
CATTATCCCATTAACG-1	not.defined
CATTATGCTTGTTGTG-1	not.defined
CATTCGTCGTAGCGGT-1	not.defined
CCAAATAACAAGATTC-1	not.defined
CCAACCTTATGTAACT-1	not.defined
CCACAGCTGAAATCAT-1	not.defined
CCACATACTGCACCCA-1	not.defined
CCACGGAGCCATAAGA-1	not.defined
CCACTGTTTGGATTAA-1	not.defined
CCAGCTCGAACGCATT-1	not.defined
CCATATTGGATCATGA-1	not.defined
CCATGCCCTAGATTTC-1	not.defined
CCATGCTCTGCAGGAA-1	not.defined
CCATGTTCATCTATAT-1	not.defined
CCATTGTTTCCTCCAT-1	not.defined
CCATTTCTACCTATTA-1	not.defined
CCCAAGTCATTACACT-1	not.defined
CCCAGGTCTGAAGGCT-1	not.defined
CCCGATAGCCTCGCCT-1	not.defined
CCCGGGTCGTTCAGGG-1	not.defined
CCCGTAGCTGGGAAGA-1	not.defined
CCCGTTTCGCAGATGT-1	not.defined
CCCTACTTGAACAATG-1	not.defined
CCCTAGGCAACAAGAG-1	not.defined
CCCTCGATAATACACA-1	not.defined
CCCTGGCTGTTCCTTC-1	not.defined
CCCTTTAATGGAGTTC-1	not.defined
CCGACAATAGGCCGCC-1	not.defined
CCGATATGACGTAAGG-1	not.defined
CCGCCGGAACTTCTCG-1	not.defined
CCGCCTGCGAATTGGT-1	not.defined
CCGCGGAATGCGTCAC-1	not.defined
CCGCTCCGGATAAGCT-1	not.defined
CCGCTCTTCCGAACTA-1	not.defined
CCGGAAGTTATCAGTC-1	not.defined
CCGTAGGGTTGTTTAC-1	not.defined
CCGTATCTCGTCGTAG-1	not.defined
CCTAAATTGTATCCTA-1	not.defined
CCTATAATGAGTGCCC-1	not.defined
CCTATACCGTCCTGTC-1	not.defined
CCTATATTTGTCCTGG-1	not.defined
CCTATGGTCAAAGCTG-1	not.defined
CCTATTATTCCGGCCG-1	not.defined
CCTCCTGTTGTGTCGT-1	not.defined
CCTCTATCGATTAGCA-1	not.defined
CCTGAGAATAAATGCA-1	not.defined
CCTGTAAGACATGATA-1	not.defined
CCTGTCGTGTATGAAG-1	not.defined
CCTGTTTGAAGACACG-1	not.defined
CCTTGACCACTTTATT-1	not.defined
CCTTTAAGGGAGCACT-1	not.defined
CCTTTGAATTATGGCT-1	not.defined
CGAACCTCTTTCCTAG-1	not.defined
CGAAGGGTTTCAGATT-1	not.defined
CGAATGGTAGGTCGTC-1	not.defined
CGACCGTTGGTATTCG-1	not.defined
CGAGAGCTTTCACTAC-1	not.defined
CGAGAGGGTAGCCGCG-1	not.defined
CGAGATTTCGCTCGGG-1	not.defined
CGAGCACTTCAAGTTT-1	not.defined
CGAGTGAAGGTACCAG-1	not.defined
CGAGTGCTATAGTTCG-1	not.defined
CGATCCTCGCAACATA-1	not.defined
CGATTTGTCATTAATG-1	not.defined
CGCACGTCTGTTTATG-1	not.defined
CGCAGGCGATCCAAAC-1	not.defined
CGCATGCCGAATGCGT-1	not.defined
CGCCCAGCGTTTCACG-1	not.defined
CGCCGTCTACCCATCG-1	not.defined
CGCGAAGTGGCATACT-1	not.defined
CGCGACCGCGACAGAT-1	not.defined
CGCGCAAATGTCCAGA-1	not.defined
CGCGGCAGTATTACGG-1	not.defined
CGCTTAGTATTGATAC-1	not.defined
CGCTTCGGTCTAAGAC-1	not.defined
CGGAAAGAATCAAACG-1	not.defined
CGGCAATAAGATCGCC-1	not.defined
CGGGAACGCCCTGCAT-1	not.defined
CGGGCGATGGATCACG-1	not.defined
CGGGTTTGTTAGGGCT-1	not.defined
CGGTCAGTCCATATTT-1	not.defined
CGGTCCGTCGCAAGCC-1	not.defined
CGGTGGGCTCCAGCCT-1	not.defined
CGGTTTACTGAACATT-1	not.defined
CGTAGAGAGTAATTAT-1	not.defined
CGTCGCATGTGAGCCA-1	not.defined
CGTCGCGGCGGGATTT-1	not.defined
CGTCGGGTCTAAGCGC-1	not.defined
CGTGACCAGTCCTCTG-1	not.defined
CGTGGAAGCCTCGTAC-1	not.defined
CGTGTATGGGAGCTGA-1	not.defined
CGTGTCCCATTCGCGA-1	not.defined
CGTGTCTCGTTACGAC-1	not.defined
CGTTAAACTAGTTAGG-1	not.defined
CGTTAATGTCCCGACG-1	not.defined
CGTTCATGGTGCGCGT-1	not.defined
CGTTGAATACCGCGCT-1	not.defined
CGTTGCCCGCGTGGGA-1	not.defined
CGTTTGGTGTTGTGGG-1	not.defined
CTAAATCCGGTGTACA-1	not.defined
CTACGATCCTATCCTA-1	not.defined
CTAGCTTAATGGTCCC-1	not.defined
CTATAAGTAGGGTTTG-1	not.defined
CTATACTTAAAGCGAG-1	not.defined
CTATAGGCGTTGATGT-1	not.defined
CTATATCCAGCCTGGC-1	not.defined
CTATCGCGTAGAGAAC-1	not.defined
CTATGGGAAGCGGAAT-1	not.defined
CTCAAACCACTGCCCG-1	not.defined
CTCAGGACTCACCTGT-1	not.defined
CTCCCAATGAGTCGCG-1	not.defined
CTCGCATTGCATAGCC-1	not.defined
CTCGCCGAATGTAGGG-1	not.defined
CTCGTCTGTGCCTTCG-1	not.defined
CTGACATAGAAATAGA-1	not.defined
CTGCAAGCACGTTCCG-1	not.defined
CTGCACTCCAGTACAG-1	not.defined
CTGGGATACGCTACCC-1	not.defined
CTGGTAAAGTGTGGGC-1	not.defined
CTGGTTCGCGAGCTAC-1	not.defined
CTGTAGCCATCTCACT-1	not.defined
CTGTAGTGAGGATCGA-1	not.defined
CTTAGGTATAGACCAG-1	not.defined
CTTAGTTGAGGAATCG-1	not.defined
CTTATAGATGGCTGTT-1	not.defined
CTTCAACTCCACTTGG-1	not.defined
CTTCCGCTCCGTGAAG-1	not.defined
CTTCGGCCAATTGTTT-1	not.defined
CTTCTATTAATGCTAG-1	not.defined
CTTCTGGGCGTACCTA-1	not.defined
CTTGAGGTTATCCCGA-1	not.defined
CTTGTTTATGTAGCCA-1	not.defined
CTTTGCATCGCTCTTG-1	not.defined
CTTTGCTGTCATGGAT-1	not.defined
GAAAGCAGTGCACTTT-1	not.defined
GAACAACTGGGATGAA-1	not.defined
GAACCCTCTGTGTTCT-1	not.defined
GAACTGTGGAGAGACA-1	not.defined
GAAGCCACTGATTATG-1	not.defined
GAAGCCTGCACATTCC-1	not.defined
GAATAGTGCTCGATTA-1	not.defined
GAATGCGAATCGGTTC-1	not.defined
GACACTGGAACCCGAT-1	not.defined
GACCACACTTCCCTTT-1	not.defined
GACCGATTAAATATGT-1	not.defined
GACCGCGTCTGACGTG-1	not.defined
GACCTTCCACGTCTAC-1	not.defined
GACGTGTAGGGATTAT-1	not.defined
GACTAGGCCGTTAGGT-1	not.defined
GACTCCTTCCAATTGA-1	not.defined
GACTGCAAATCGAGCT-1	not.defined
GACTGCGGCACGTGTA-1	not.defined
GAGAACGGTTCTGACT-1	not.defined
GAGAATCTCACGATCA-1	not.defined
GAGAGCGCAGTCCCTG-1	not.defined
GAGATGACAATCCTTA-1	not.defined
GAGCACGGCGCCTCTT-1	not.defined
GAGCATCAACAACTTG-1	not.defined
GAGCGCAAATACTCCG-1	not.defined
GAGCTAAGGGCATATC-1	not.defined
GAGGAATATCTCTTTG-1	not.defined
GAGGATAAACAGTGCT-1	not.defined
GAGGCCTGTTGATACA-1	not.defined
GAGGGTAGTAACAAAG-1	not.defined
GAGTAAACCGGAAAGT-1	not.defined
GAGTAGATACTAGTTG-1	not.defined
GAGTATACCCTAATCA-1	not.defined
GAGTATGCGCGTGCAT-1	not.defined
GAGTTCTGTGGGTGCT-1	not.defined
GATACCGTGTCGGAGT-1	not.defined
GATAGGATTAATTACA-1	not.defined
GATAGGTGTCCCGGGC-1	not.defined
GATCAACATAAAGGGA-1	not.defined
GATCCGAATATAAGTG-1	not.defined
GATCTAACCGTATTCA-1	not.defined
GATGACGATGATCGCG-1	not.defined
GATGTAACGAACCACC-1	not.defined
GATTCCCTTGTCGCAG-1	not.defined
GATTGGGAAAGGTTGT-1	not.defined
GCAAACCTTGGCCATA-1	not.defined
GCAAAGGGCGTTAGCC-1	not.defined
GCAATTAGTCGCACCG-1	not.defined
GCACGTGGTTTACTTA-1	not.defined
GCACTGCCTACCTTTA-1	not.defined
GCAGAAGGTAATCTCC-1	not.defined
GCATCGGCCGTGTAGG-1	not.defined
GCATGCTAATAACGAT-1	not.defined
GCCCAGATGCTGGAGA-1	not.defined
GCCCTAGCCGTCGCGA-1	not.defined
GCCGACCCACGACTGC-1	not.defined
GCCGCACTCCGTTTCA-1	not.defined
GCCGCATTAGTCCGGC-1	not.defined
GCCTATCAGGTAAGAT-1	not.defined
GCCTCCGACAATTCAC-1	not.defined
GCCTTTGTCAGTGGAC-1	not.defined
GCGCAAATATATTCAA-1	not.defined
GCGGAGAAACTTCGCA-1	not.defined
GCGTTCTGACTAAGCG-1	not.defined
GCTAGCACCTGGGCCA-1	not.defined
GCTAGCAGGGAGTGGG-1	not.defined
GCTAGCGATAGGTCTT-1	not.defined
GCTCCATGAGTGCAGA-1	not.defined
GCTCCTGACATACTGG-1	not.defined
GCTGAACTCTCCAGGG-1	not.defined
GCTGAATCTTCCAATC-1	not.defined
GCTGGGAGCGCGTCAA-1	not.defined
GGAACTTTGGCGATTA-1	not.defined
GGACAAGTTGCAGTGA-1	not.defined
GGACCTACGGTAACGT-1	not.defined
GGACTCTTTGACTAAG-1	not.defined
GGAGCGAGGCCTACTT-1	not.defined
GGAGGCCGAAGTCGTC-1	not.defined
GGAGGGTCAAGTAAGA-1	not.defined
GGATCTTACTGCCCTT-1	not.defined
GGATGACGCGAGTTTA-1	not.defined
GGATGGCTTGAAGTAT-1	not.defined
GGATTCCGCTATACCC-1	not.defined
GGATTGCTGTGACTCC-1	not.defined
GGCACTCAGCCGACCC-1	not.defined
GGCCCGGAGCATGTCT-1	not.defined
GGCCCGTATACCATGC-1	not.defined
GGCCGAGACTCTGGTG-1	not.defined
GGCCGGCGTCTGCTAT-1	not.defined
GGCCGTTTGGGTTTCA-1	not.defined
GGCGCGGAGATCTTTC-1	not.defined
GGCGCTTCATTCCCTG-1	not.defined
GGGAACGGTTTCAGAT-1	not.defined
GGGAAGGGCTTTCTCA-1	not.defined
GGGACCCGTATATCTT-1	not.defined
GGGAGCGACCGTAGTG-1	not.defined
GGGCACGTAGTACTGT-1	not.defined
GGGCACTATTGACCAT-1	not.defined
GGGCAGAGCAATCGTT-1	not.defined
GGGCCTAAATGGGCTA-1	not.defined
GGGCGGTCCTATTGTC-1	not.defined
GGGCGTACATTTATAT-1	not.defined
GGGCTATGATCGATGG-1	not.defined
GGGTACCCACGGTCCT-1	not.defined
GGGTCAGGAGCTAGAT-1	not.defined
GGGTCTATCGCTTTCC-1	not.defined
GGTACTAAGTGCTTTG-1	not.defined
GGTCAAGACTACTTCG-1	not.defined
GGTCTTGAGCGCTCTT-1	not.defined
GGTGAACGGGCTAGCC-1	not.defined
GGTGGAGGTTGATACG-1	not.defined
GGTGTAGGTAAGTAAA-1	not.defined
GGTGTTGGGCGTCTTA-1	not.defined
GTAACTGCCCAAGGAG-1	not.defined
GTAACTTGCGGCAGTC-1	not.defined
GTAGACACGCCTGACT-1	not.defined
GTAGGTGATCCGTGTA-1	not.defined
GTATCAGCTTGGGTTC-1	not.defined
GTATCCTTTGGTAACC-1	not.defined
GTATTTAATGGCATAA-1	not.defined
GTCACTCATGAGCGAT-1	not.defined
GTCATGCGCGAGGGCT-1	not.defined
GTCCAATATTTAGCCT-1	not.defined
GTCCCGCGACGTTATG-1	not.defined
GTCCTACTCTACGGGC-1	not.defined
GTCCTAGGATACCTTA-1	not.defined
GTCGATAGGTGACTTT-1	not.defined
GTCGGGAAGCAGAAAC-1	not.defined
GTCGTCTGGTTGGCTA-1	not.defined
GTCTAGTGAGCCGCTT-1	not.defined
GTCTATTGCATGCTCG-1	not.defined
GTCTCAAGGCCCGGCT-1	not.defined
GTCTCCTGCCAGTATG-1	not.defined
GTCTTGAGGAGCAGTG-1	not.defined
GTCTTGTAGCTATTCA-1	not.defined
GTGACAGCTTCCCACT-1	not.defined
GTGACCTAAAGAATAA-1	not.defined
GTGCAGCGTAGAGTAG-1	not.defined
GTGGAACCTACATGCG-1	not.defined
GTGGAGCATGTCGGCC-1	not.defined
GTGGCTGTTTCTGTTC-1	not.defined
GTGGTATAGTCTGCCG-1	not.defined
GTGGTGATGGTTTGTG-1	not.defined
GTGTACCTTGGCTACG-1	not.defined
GTGTACGAACCGTTCC-1	not.defined
GTGTCAGTGTACGTGG-1	not.defined
GTGTCGTATAGCGTTC-1	not.defined
GTTCCAGTCTGACCAT-1	not.defined
GTTCCCGTAAACATAT-1	not.defined
GTTCGGAGCACTCAAC-1	not.defined
GTTGCGCTAACATTAC-1	not.defined
GTTGGATTCAGTGGCT-1	not.defined
GTTTATGGGATTTAGA-1	not.defined
GTTTCAAACGAGTTGT-1	not.defined
GTTTCATATCGTCGCT-1	not.defined
GTTTGGTGATCGGTGC-1	not.defined
TAAACCCAGGAGGGCA-1	not.defined
TAAAGACAACCCTTTA-1	not.defined
TAACAGCGTTTGTGCT-1	not.defined
TAAGGCATAACATCAA-1	not.defined
TAAGGCCCGTCACCCT-1	not.defined
TAATACTAGAACAGAC-1	not.defined
TAATCAACCAAATGGG-1	not.defined
TAATGTCGGTTCATGG-1	not.defined
TACATGCCGGAATTGT-1	not.defined
TACCAGGAATCCCGTC-1	not.defined
TACCATGTATTGATTT-1	not.defined
TACCGAATAATTGTAA-1	not.defined
TACCGGTCGTTTCCAT-1	not.defined
TACCTACTCCCAGTAT-1	not.defined
TACCTCCACACCAATG-1	not.defined
TACGTGCAAGGTTCCT-1	not.defined
TACTATGGTTCCTCAG-1	not.defined
TACTCCTCTAGTTGAC-1	not.defined
TACTCTTACTTTACTG-1	not.defined
TACTCTTTCGTCTTCA-1	not.defined
TAGAAAGGTGGCGCTA-1	not.defined
TAGCAACCTGTCACAA-1	not.defined
TAGCAGTATGACTAAA-1	not.defined
TAGGCGGCTGCAAAGA-1	not.defined
TAGGCTAAAGTGGCAC-1	not.defined
TAGGTGTTCCACAGAT-1	not.defined
TAGTACCTTAGTGGTC-1	not.defined
TAGTCCCGGAGACCAC-1	not.defined
TAGTCTTTCCGAATTG-1	not.defined
TAGTGCTTGAATCCTT-1	not.defined
TATACGCGTCATCACT-1	not.defined
TATAGAGTCGCTTGAA-1	not.defined
TATATCAAAGTGATCT-1	not.defined
TATATTACAAATGTCG-1	not.defined
TATCAGTGGCGTAGTC-1	not.defined
TATCCGCACCGTCGGG-1	not.defined
TATGAAGAATTAAGGT-1	not.defined
TATGGATGTGCTACGC-1	not.defined
TATGTAAAGTGCTTAA-1	not.defined
TATTAACACCAAAGCA-1	not.defined
TATTAACCTGACCGCG-1	not.defined
TATTATGTTTGCCTGC-1	not.defined
TATTTGTTACCCTTTA-1	not.defined
TCAAATTGTTGTGCCG-1	not.defined
TCAAATTTGAGACTCA-1	not.defined
TCAACAAAGATAATTC-1	not.defined
TCAACTGCAGAGTCAG-1	not.defined
TCAAGCGCGGACGGTA-1	not.defined
TCACAGGAGAATAAGA-1	not.defined
TCACGATGTCCGTGGA-1	not.defined
TCAGGTTCTTTGAGAA-1	not.defined
TCAGTGTATACGTCAT-1	not.defined
TCATCGACGACCGTCG-1	not.defined
TCATCGATGGTCCCAA-1	not.defined
TCCAATAAAGGCTACC-1	not.defined
TCCAGCGCTATAAGCG-1	not.defined
TCCAGGGTATATACGA-1	not.defined
TCCCAAAGCCCTAAAT-1	not.defined
TCCCAGGCTTAGCTAA-1	not.defined
TCCGCCTGTCTACAAG-1	not.defined
TCCGGCTGTCGGGTCG-1	not.defined
TCCGGGCTTGACGGGA-1	not.defined
TCCTAAATTGGGAAGC-1	not.defined
TCCTCTACGAGATGGC-1	not.defined
TCGACAACTGAACCCG-1	not.defined
TCGCCGACATATTCGC-1	not.defined
TCGCTACTGGCTTTGA-1	not.defined
TCGCTGCCAATGCTGT-1	not.defined
TCGGCTTGTATCGACG-1	not.defined
TCGGGAGACAGCGTAC-1	not.defined
TCGGTCCCGACAATAG-1	not.defined
TCGTAAGCTCCGAGGA-1	not.defined
TCGTGTATTGGTCACG-1	not.defined
TCGTGTCACGCTGACA-1	not.defined
TCGTTGCTATCCGGTC-1	not.defined
TCTAATACTGCCTCAG-1	not.defined
TCTACCCAATAGAGAG-1	not.defined
TCTACGCACGATCTCC-1	not.defined
TCTCGAGGAGGTTCGC-1	not.defined
TCTCTTACCGCGAACC-1	not.defined
TCTGAAGCACGTGGTC-1	not.defined
TCTGACTGTAATGGTT-1	not.defined
TCTGAGCAATTGACTG-1	not.defined
TCTGATCGGGTGCTAG-1	not.defined
TCTGGCCGTTCAAGTT-1	not.defined
TCTGTTACCCAGCATA-1	not.defined
TCTTGCTCCCGATACT-1	not.defined
TCTTTAGAGTCTAACA-1	not.defined
TCTTTCATCCGTCCTT-1	not.defined
TCTTTCCTTCGAGATA-1	not.defined
TGAACAAGCAGGGACT-1	not.defined
TGAACTGCTATGACTT-1	not.defined
TGAATACCGACGCGTA-1	not.defined
TGAATGAGTGTTTCCC-1	not.defined
TGAATGTCAGCCGGCC-1	not.defined
TGACACTTCTCTTTGC-1	not.defined
TGAGCTCAACTGTATA-1	not.defined
TGAGGAGTGCCAGCTT-1	not.defined
TGAGGTGTGTGGCGGA-1	not.defined
TGATCACCACACTGAC-1	not.defined
TGATGTCAATTAAGTG-1	not.defined
TGCAACTACTGGTTGA-1	not.defined
TGCATGGATCGGATCT-1	not.defined
TGCATGTGACCCATAG-1	not.defined
TGCCGGATGTACGAGC-1	not.defined
TGCCTAAATTTAATAG-1	not.defined
TGCGACGGCCGAACGT-1	not.defined
TGCGCCGTTAATAACG-1	not.defined
TGCGGACTTGACTCCG-1	not.defined
TGCGTACGGCTAATTG-1	not.defined
TGCGTCATGACTGAGC-1	not.defined
TGCTATGGCAAAGGGA-1	not.defined
TGCTCGGCGAAACCCA-1	not.defined
TGCTCGGTGGGTCACC-1	not.defined
TGCTCTTGAGAGTTTG-1	not.defined
TGCTTCCCAAGCAGTA-1	not.defined
TGGAAGACGAACACCA-1	not.defined
TGGACGTAGGCGAATC-1	not.defined
TGGCAATGGGACGGCG-1	not.defined
TGGCCAATTTGGTACT-1	not.defined
TGGCTATGTGACATAC-1	not.defined
TGGGCAGGCCACCGCA-1	not.defined
TGGGCCTTGCCTGCAT-1	not.defined
TGGGTGCACAAGCCAT-1	not.defined
TGGGTTTCGGGCGTAC-1	not.defined
TGGTTAACTTACATTT-1	not.defined
TGTAAGACTGATAAGA-1	not.defined
TGTAGCCATCCCATTC-1	not.defined
TGTCATTTGTTGGGAA-1	not.defined
TGTCCACGGCTCAACT-1	not.defined
TGTTTCTGAAGCGTGC-1	not.defined
TTAACACCTCGAACAT-1	not.defined
TTAAGGCCCGTACTTT-1	not.defined
TTAAGTATTGTTATCC-1	not.defined
TTACGTATCTATGACA-1	not.defined
TTAGCAACATGGATGT-1	not.defined
TTAGGATGGGAGGGTA-1	not.defined
TTAGTAAACCTGCTCT-1	not.defined
TTATCCGGGATCTATA-1	not.defined
TTCACGAAAGGATCAC-1	not.defined
TTCACTCGAGCACCTA-1	not.defined
TTCAGTTTGTGGCAGC-1	not.defined
TTCATAGGGTGTCCAT-1	not.defined
TTCCGGTATCTGTGTC-1	not.defined
TTCGGGTTGCCACGGG-1	not.defined
TTCTATGCCTTTCGCA-1	not.defined
TTCTATTAAACGCAGC-1	not.defined
TTCTTGGACGATCTGC-1	not.defined
TTCTTTGGTCGCGACG-1	not.defined
TTGAACGACGTGCTGA-1	not.defined
TTGAAGAATTCCCAGG-1	not.defined
TTGAGCGCCACGTGAT-1	not.defined
TTGAGTCCCGCTGCTG-1	not.defined
TTGATGCCGCTCGTCG-1	not.defined
TTGATTAGCTGTTTCT-1	not.defined
TTGCCGCAGACCTACA-1	not.defined
TTGCGTGTGTAGGCAT-1	not.defined
TTGGCGATCCGAATAT-1	not.defined
TTGGGACGTAAGAGTT-1	not.defined
TTGGTTCGCTCAAAGG-1	not.defined
TTGTGGTGGTACTAAG-1	not.defined
