cell.names	copykat.pred
AAACAACGAATAGTTC-1	aneuploid
AAACAAGTATCTCCCA-1	diploid
AAACAATCTACTAGCA-1	aneuploid
AAACACCAATAACTGC-1	diploid
AAACAGAGCGACTCCT-1	diploid
AAACAGCTTTCAGAAG-1	aneuploid
AAACAGGGTCTATATT-1	diploid
AAACAGTGTTCCTGGG-1	diploid
AAACATGGTGAGAGGA-1	diploid
AAACATTTCCCGGATT-1	diploid
AAACCACTACACAGAT-1	aneuploid
AAACCCGAACGAAATC-1	diploid
AAACCGGGTAGGTACC-1	aneuploid
AAACCGTTCGTCCAGG-1	diploid
AAACCTAAGCAGCCGG-1	diploid
AAACCTCATGAAGTTG-1	aneuploid
AAACGAAGAACATACC-1	aneuploid
AAACGAAGATGGAGTA-1	diploid
AAACGACAGTCTTGCC-1	aneuploid
AAACGCCCGAGATCGG-1	aneuploid
AAACGGGCGTACGGGT-1	diploid
AAACGGGTTGGTATCC-1	aneuploid
AAACGGTTGCGAACTG-1	diploid
AAACGTGTTCGCCCTA-1	aneuploid
AAACTAACGTGGCGAC-1	aneuploid
AAACTCGGTTCGCAAT-1	diploid
AAACTCGTGATATAAG-1	diploid
AAACTGCTGGCTCCAA-1	diploid
AAACTTAATTGCACGC-1	diploid
AAACTTGCAAACGTAT-1	aneuploid
AAAGAATGACCTTAGA-1	diploid
AAAGAATGTGGACTAA-1	diploid
AAAGACATGAAGTTTA-1	aneuploid
AAAGACCCAAGTCGCG-1	aneuploid
AAAGACTGGGCGCTTT-1	aneuploid
AAAGCTTGCCTACATA-1	diploid
AAAGGCCCTATAATAC-1	diploid
AAAGGCTCTCGCGCCG-1	diploid
AAAGGGATGTAGCAAG-1	aneuploid
AAAGGGCAGCTTGAAT-1	aneuploid
AAAGGTAAGCTGTACC-1	aneuploid
AAAGGTCAACGACATG-1	aneuploid
AAAGTAGCATTGCTCA-1	diploid
AAAGTCACTGATGTAA-1	aneuploid
AAAGTCGACCCTCAGT-1	aneuploid
AAAGTGTGATTTATCT-1	diploid
AAAGTTGACTCCCGTA-1	diploid
AAATAACCATACGGGA-1	aneuploid
AAATAAGGTAGTGCCC-1	diploid
AAATACCTATAAGCAT-1	diploid
AAATAGCTTAGACTTT-1	diploid
AAATAGGGTGCTATTG-1	diploid
AAATCACTCCTAAACG-1	aneuploid
AAATCCGATACACGCC-1	diploid
AAATCGCGGAAGGAGT-1	diploid
AAATCGTGTACCACAA-1	diploid
AAATCTAGCCCTGCTA-1	diploid
AAATCTGCCCGCGTCC-1	diploid
AAATGACTGATCAAAC-1	diploid
AAATGATTCGATCAGC-1	diploid
AAATGCTCGTTACGTT-1	aneuploid
AAATGGCATGTCTTGT-1	aneuploid
AAATGGCCCGTGCCCT-1	diploid
AAATGGTCAATGTGCC-1	aneuploid
AAATGTATCTTATCCC-1	aneuploid
AAATGTGGGTGCTCCT-1	aneuploid
AAATTAACGGGTAGCT-1	aneuploid
AAATTAATAAGCGCGA-1	aneuploid
AAATTACACGACTCTG-1	aneuploid
AAATTACCTATCGATG-1	diploid
AAATTCCAGGTCCAAA-1	diploid
AAATTGATAGTCCTTT-1	diploid
AAATTGCGGCGGTTCT-1	aneuploid
AAATTGGTGAGAAGCA-1	diploid
AAATTTACCGAAATCC-1	aneuploid
AAATTTGCGGGTGTGG-1	aneuploid
AACAACTGGTAGTTGC-1	aneuploid
AACAATACATTGTCGA-1	diploid
AACAATTACTCTACGC-1	aneuploid
AACACACGCTCGCCGC-1	diploid
AACACGACTGTACTGA-1	aneuploid
AACACGAGACGCGGCC-1	aneuploid
AACACGCGGCCGCGAA-1	aneuploid
AACAGCTGTGTGGCAA-1	diploid
AACAGGAAATCGAATA-1	aneuploid
AACAGGATGGGCCGCG-1	aneuploid
AACATAGCGTGTATCG-1	diploid
AACATATCAACTGGTG-1	diploid
AACATCGATACGTCTA-1	diploid
AACATTGAAGTTGATC-1	diploid
AACATTGGTCAGCCGT-1	aneuploid
AACATTGTGACTCGAG-1	diploid
AACCAAGACTTCTCTG-1	aneuploid
AACCAGTATCACTCTT-1	aneuploid
AACCATAGGGTTGAAC-1	diploid
AACCATGGGATCGCTA-1	aneuploid
AACCCAGAGACGGAGA-1	aneuploid
AACCCATCCCATGATC-1	diploid
AACCCGACAACCCGTG-1	diploid
AACCCGAGCAGAATCG-1	diploid
AACCCGATAGGGCTTC-1	aneuploid
AACCCGCTGTATTCCA-1	diploid
AACCCTACTGTCAATA-1	diploid
AACCCTGGTGGAACCA-1	aneuploid
AACCGAGCTTGGTCAT-1	aneuploid
AACCGCTAAGGGATGC-1	diploid
AACCGTTGTGTTTGCT-1	aneuploid
AACCTAAAGCCGTCCG-1	aneuploid
AACCTCGCTTTAGCCC-1	diploid
AACCTGTCACGGAATT-1	diploid
AACCTTTACGACGTCT-1	aneuploid
AACGAAAGTCGTCCCA-1	diploid
AACGACCTCCTAGCCG-1	diploid
AACGATAGAAGGGCCG-1	aneuploid
AACGATATGTCAACTG-1	aneuploid
AACGCATGATCTGGGT-1	diploid
AACGCGAACGGCAACA-1	aneuploid
AACGCGACCTTGGGCG-1	diploid
AACGCGGTCTCCAGCC-1	aneuploid
AACGCTGTTGCTGAAA-1	diploid
AACGGACGTACGTATA-1	diploid
AACGGCCATCTCCGGT-1	diploid
AACGTACTGTGGGTAC-1	diploid
AACGTAGTCTACCCAT-1	aneuploid
AACGTCAGACTAGTGG-1	aneuploid
AACGTCGCTGCACTTC-1	diploid
AACGTGATGAAGGACA-1	aneuploid
AACGTTATCAGCACCT-1	aneuploid
AACTACCCGTTTGTCA-1	diploid
AACTAGCGTATCGCAC-1	aneuploid
AACTAGGCTTGGGTGT-1	diploid
AACTCAAGTTAATTGC-1	diploid
AACTCCAGAGCGTGTT-1	diploid
AACTCCTAATCCCATG-1	aneuploid
AACTCGATAAACACGT-1	aneuploid
AACTCGATGGCGCAGT-1	aneuploid
AACTCTCAATAGAGCG-1	diploid
AACTCTCAGTGTGCTC-1	diploid
AACTGAGGTCAGCGTC-1	aneuploid
AACTGATATTAGGCCT-1	aneuploid
AACTGGGTCCCGACGT-1	aneuploid
AACTGGGTTCGAGCCG-1	aneuploid
AACTGGTGTGGGCCTT-1	aneuploid
AACTTCTGCGTCTATC-1	aneuploid
AACTTGCCCGTATGCA-1	aneuploid
AACTTGCGTTCTCGCG-1	aneuploid
AACTTTACGGGAGCTT-1	aneuploid
AACTTTAGCTGCTGAG-1	aneuploid
AACTTTCTCGATCATG-1	diploid
AAGAAAGTTTGATGGG-1	diploid
AAGAAATCACCAGATT-1	diploid
AAGAAGGATCAGTTAG-1	aneuploid
AAGACATACGTGGTTT-1	diploid
AAGACCAAATAACTCA-1	diploid
AAGACTAACCCGTTGT-1	aneuploid
AAGACTCACGCCCACT-1	aneuploid
AAGAGATGAATCGGTA-1	aneuploid
AAGAGGCCCTTTGGAA-1	diploid
AAGATGGCACCGGACC-1	diploid
AAGATTGGCGGAACGT-1	aneuploid
AAGCATACTCTCCTGA-1	diploid
AAGCCACTTGCAGGTA-1	diploid
AAGCCGCCGTGAAATC-1	diploid
AAGCCGCTTTACCTTG-1	diploid
AAGCGCAGGGCTTTGA-1	diploid
AAGCGGAGTGCGCGCA-1	diploid
AAGCGGCGTCATGGGT-1	aneuploid
AAGCGTCCCTCATCGA-1	diploid
AAGCTAGATCGAGTAA-1	diploid
AAGCTATGGATTGACC-1	diploid
AAGCTCTTTCATGGTG-1	diploid
AAGGAGCGGTTGGTGC-1	aneuploid
AAGGATCGATCGCTTG-1	diploid
AAGGATGAGGGACCTC-1	aneuploid
AAGGCAGGCTGTCTCC-1	diploid
AAGGCGCGTAAAGCTT-1	aneuploid
AAGGCTGTGCTCATCG-1	aneuploid
AAGGGAACGACTGGCT-1	diploid
AAGGGACAGATTCTGT-1	aneuploid
AAGGGACTATGCATTC-1	diploid
AAGGGTTTGATTTCAG-1	diploid
AAGGTATCCTAATATA-1	aneuploid
AAGGTGATAAACCAGC-1	diploid
AAGTAAGCTTCCAAAC-1	aneuploid
AAGTAGAAGACCGGGT-1	aneuploid
AAGTAGTGACGCGAGG-1	aneuploid
AAGTCAATTGTCGTCA-1	diploid
AAGTCTAGTAGCTGCC-1	diploid
AAGTCTTCTGTGGCCT-1	aneuploid
AAGTGACGACCGAATT-1	aneuploid
AAGTGAGTCGGGTTTA-1	diploid
AAGTGCAAAGGTAGAC-1	aneuploid
AAGTGCCTTGACTGTA-1	diploid
AAGTGCGTTAGAATCT-1	aneuploid
AAGTGCTTCTCTATTG-1	diploid
AAGTGTTTGGAGACGG-1	diploid
AAGTTCACTCCAAGCT-1	diploid
AAGTTCAGTCTGCGTA-1	aneuploid
AAGTTCGGCCAACAGG-1	aneuploid
AAGTTGTGATGTTATA-1	diploid
AAGTTTACTAATGGCA-1	aneuploid
AAGTTTATGGGCCCAA-1	diploid
AATAACAACGCTCGGC-1	aneuploid
AATAAGTCCTCGAGAC-1	aneuploid
AATAATCTTCGTATCG-1	diploid
AATACAATGTTTCAGG-1	aneuploid
AATACCGGAGGGCTGT-1	diploid
AATACCTGATGTGAAC-1	diploid
AATAGAACAGAGTGGC-1	diploid
AATAGAATCTGTTTCA-1	diploid
AATAGCAAGCCTCCTG-1	aneuploid
AATAGCTACCGCGTGC-1	diploid
AATAGTCCGTCCCGAC-1	diploid
AATAGTCGCGAGTCGG-1	aneuploid
AATATCAAGGTCGGAT-1	aneuploid
AATATCCTAGCAAACT-1	aneuploid
AATATCGAGGGTTCTC-1	diploid
AATATTGGAGTATTGA-1	aneuploid
AATCAGACTGCAGGAC-1	aneuploid
AATCAGGTTTCATTTA-1	diploid
AATCATGTAAAGACTC-1	diploid
AATCCAAGGGCCTGAG-1	aneuploid
AATCCATGCAAGGGTG-1	aneuploid
AATCGAGGTCTCAAGG-1	diploid
AATCGCCTCAGCGCCA-1	diploid
AATCGCGCAGAGGACT-1	diploid
AATCGGGACACTACGA-1	aneuploid
AATCGGTATAGCCCTC-1	diploid
AATCGTGAGCCGAGCA-1	diploid
AATCTAGGTTTACTTG-1	diploid
AATCTATGCCGGAGCC-1	diploid
AATCTGCGTTGGGACG-1	diploid
AATCTGGCTTTCTAGT-1	diploid
AATCTGGGTAGACCCT-1	aneuploid
AATGACAGCAATGTCT-1	aneuploid
AATGACGTAGGATGTC-1	diploid
AATGACTGTCAGCCGG-1	aneuploid
AATGAGTTCGCATATG-1	aneuploid
AATGATGATACGCTAT-1	aneuploid
AATGATGCGACTCCTG-1	diploid
AATGCAACCGGGTACC-1	aneuploid
AATGCACCAAGCAATG-1	aneuploid
AATGGCCGCCAATGCG-1	aneuploid
AATGGTCCACCGTTCA-1	aneuploid
AATGGTTCTCACAAGC-1	aneuploid
AATGTATGGCACTGTA-1	diploid
AATGTGCCCGAGGTGT-1	diploid
AATGTTAAGACCCTGA-1	diploid
AATGTTGTCGTGAGAC-1	diploid
AATTAAAGGTCGGCGT-1	diploid
AATTAACGGATTTCCA-1	diploid
AATTACGAGACCCATC-1	diploid
AATTACTCGTACGCTC-1	aneuploid
AATTAGCGCTGCAGCG-1	diploid
AATTATACCCAGCAAG-1	diploid
AATTCATAAGGGATCT-1	aneuploid
AATTCATTGTCATGCA-1	diploid
AATTCCAACTTGGTGA-1	aneuploid
AATTCCAAGCATGTAC-1	diploid
AATTCGATTCGAGGAT-1	diploid
AATTCTAGAGTTAGGC-1	diploid
AATTGAACGCTCTGGT-1	diploid
AATTGCAGCAATCGAC-1	diploid
AATTGCGTGGATTACA-1	diploid
AATTGTGGTTGCCAAA-1	diploid
AATTTGGGACATAGTA-1	aneuploid
AATTTGGTTCCAAAGA-1	aneuploid
ACAAACCATGCGTCCT-1	diploid
ACAAACCGACAAGGCG-1	aneuploid
ACAAAGAAGGTAGGCC-1	aneuploid
ACAAAGCATGACCTAG-1	diploid
ACAAATGGTAGTGTTT-1	diploid
ACAAATTCAGATCTGA-1	aneuploid
ACAACAGCATGAGCTA-1	aneuploid
ACAACGGTCCCTGCGA-1	aneuploid
ACAAGCAGTGCCTAGC-1	aneuploid
ACAAGCTATATGGAAG-1	aneuploid
ACAAGGAAATCCGCCC-1	diploid
ACAAGGACAAGAGGTT-1	aneuploid
ACAAGGATGCTTTAGG-1	diploid
ACAAGGCCTACCAGCC-1	aneuploid
ACAAGGGCAGGCTCTG-1	diploid
ACAATCCATTTAAACC-1	aneuploid
ACAATCGATCTTTATA-1	aneuploid
ACAATGAATACGGAGA-1	diploid
ACAATGATTCTTCTAC-1	aneuploid
ACAATTGTGTCTCTTT-1	diploid
ACAATTTAGGAGGCTC-1	aneuploid
ACAATTTGAGCAGTGG-1	diploid
ACAATTTGGCCATATT-1	diploid
ACACAAAGACGGGTGG-1	aneuploid
ACACAAATATTCCTAG-1	diploid
ACACACCAGGACCAGT-1	diploid
ACACACTTTCTACACG-1	aneuploid
ACACATGATCAAATCT-1	diploid
ACACATTGACGCAACA-1	aneuploid
ACACATTTCCGTAGAC-1	diploid
ACACCACATAATTAGC-1	diploid
ACACCCAGCATGCAGC-1	aneuploid
ACACCCGAGAAATCCG-1	aneuploid
ACACCCGTAAATCTGT-1	aneuploid
ACACCGAGCGCTCTTT-1	aneuploid
ACACCGGTCTGACCGC-1	diploid
ACACCTTAAGTAGGGC-1	aneuploid
ACACCTTACTACTTGC-1	diploid
ACACGAGACTCCTTCT-1	aneuploid
ACACGGCACTATGCAT-1	aneuploid
ACACGGGAACTTAGGG-1	aneuploid
ACACGTAGGCCACAAG-1	diploid
ACACTCCAATGTCACT-1	aneuploid
ACACTGATCAAGGTGT-1	diploid
ACACTGGGACAGTCGT-1	diploid
ACAGAACTGAGAACAA-1	diploid
ACAGATTAGGTTAGTG-1	aneuploid
ACAGCATAGAGCCAGT-1	aneuploid
ACAGCGACATTCTCAT-1	diploid
ACAGCGCACCCGCAGC-1	aneuploid
ACAGGAGGCGCAGCCG-1	aneuploid
ACAGGCACGGATCCTT-1	diploid
ACAGGCTTGCCCGACT-1	diploid
ACAGGTGGAGGTGAGG-1	diploid
ACAGGTGTGTTGTTGC-1	aneuploid
ACAGTAATACAACTTG-1	diploid
ACAGTATACCGTGGGA-1	diploid
ACAGTGCAGCGCATTT-1	aneuploid
ACATAAGTCGTGGTGA-1	diploid
ACATAATAAGGCGGTG-1	aneuploid
ACATCAGCTGGGACGC-1	aneuploid
ACATCCCGGCCATACG-1	diploid
ACATCCTGGTAACTGT-1	diploid
ACATCGATCGTTTACC-1	diploid
ACATCGGTCAGCCGCG-1	aneuploid
ACATCGTATGCAATGG-1	diploid
ACATCGTTAACCTAGT-1	aneuploid
ACATCTCAACGCGTAA-1	aneuploid
ACATGCTTACGGCAGC-1	diploid
ACATGGCGCCAAAGTA-1	diploid
ACATGGCTCAATTTAG-1	aneuploid
ACATTAGTTTATATCC-1	diploid
ACATTCGCGCGGAATA-1	diploid
ACATTTGAAACCTAAC-1	diploid
ACCAAACACCCAGCGA-1	diploid
ACCAAACTAGAAATCC-1	aneuploid
ACCAACACCACACACT-1	diploid
ACCAACCGCACTCCAC-1	diploid
ACCAACGCTTATTTAT-1	diploid
ACCAAGAACGCGTGTC-1	aneuploid
ACCAAGTCATCGGCAG-1	diploid
ACCAATATGCAAGTTA-1	diploid
ACCACAACTCAGAACA-1	aneuploid
ACCACAAGTTTCTATC-1	aneuploid
ACCACACGGTTGATGG-1	diploid
ACCACCAATGTAACAA-1	diploid
ACCACCCTCTCTTCTA-1	diploid
ACCACGTGCAGCTATA-1	diploid
ACCACTGTTCAAGAAG-1	aneuploid
ACCAGACCATAACAAC-1	aneuploid
ACCAGCCCGGTCTTTG-1	aneuploid
ACCAGGAGTGTGATCT-1	aneuploid
ACCAGTGCCCGGTCAA-1	aneuploid
ACCAGTGCGGGAGACG-1	diploid
ACCATATCCGCAATAA-1	diploid
ACCATCCGCCAACTAG-1	aneuploid
ACCATCGTATATGGTA-1	diploid
ACCATTAAGGGTGTCA-1	aneuploid
ACCCAACGCCCGTGGC-1	diploid
ACCCACCTACATGCTC-1	aneuploid
ACCCATCTTGAGGGTA-1	aneuploid
ACCCATTTGTCCCTCT-1	diploid
ACCCGAGCGAAATTAC-1	diploid
ACCCGATTGGTTCCGA-1	diploid
ACCCGGATGACGCATC-1	diploid
ACCCGGTTACACTTCC-1	diploid
ACCCGTAGTCTAGTTG-1	diploid
ACCCGTGTCATCAGTA-1	diploid
ACCCTATAGGACTGAG-1	aneuploid
ACCCTATGCCATATCG-1	diploid
ACCCTCCCGTCAGGGC-1	diploid
ACCCTGGTAACGCCCT-1	diploid
ACCCTTCATCTGCGAA-1	aneuploid
ACCCTTGCCTGGGTCG-1	diploid
ACCCTTTAGTTCTCCA-1	aneuploid
ACCGAAAGGGCCCTGC-1	aneuploid
ACCGAAGAGTCTGGTT-1	diploid
ACCGACACATCTCCCA-1	diploid
ACCGACTGAGTCCCAC-1	aneuploid
ACCGAGTCTCCTTATT-1	diploid
ACCGATAGGCATAACC-1	diploid
ACCGATATTTAATCAT-1	diploid
ACCGATGGTAGCATCG-1	diploid
ACCGCGGTGGAAGTCG-1	diploid
ACCGCTAGTCATTGGT-1	diploid
ACCGGGCCTTTGTTGA-1	diploid
ACCGGTCAGGTACACC-1	diploid
ACCGGTCTGAGTACGG-1	aneuploid
ACCGTCCACTGGGCCC-1	diploid
ACCGTGACCACGTGGG-1	diploid
ACCGTTCCCGCTCTGA-1	aneuploid
ACCTAAGTACCTTTCA-1	diploid
ACCTAATCGACTTCCT-1	aneuploid
ACCTACAGTATGTGGT-1	diploid
ACCTACTATAAATCTA-1	diploid
ACCTCCGCCCTCGCTG-1	diploid
ACCTCCGTTATTCACC-1	diploid
ACCTCGAACTTATGCT-1	diploid
ACCTGCGTGTCATGTT-1	aneuploid
ACCTTTCCTTTAGAAG-1	aneuploid
ACGAAATGGGCGGCAC-1	aneuploid
ACGACTCTAGGGCCGA-1	diploid
ACGACTGGTCATACTC-1	diploid
ACGAGAACCCATCACG-1	aneuploid
ACGAGATATTTGCTTA-1	aneuploid
ACGAGGATACCACTCT-1	diploid
ACGAGGTTTACAACGT-1	diploid
ACGAGTACGGATGCCC-1	diploid
ACGAGTCGCCGGCGTT-1	aneuploid
ACGATACATAGAACTA-1	aneuploid
ACGATACCTATCCTGA-1	aneuploid
ACGATCATACATAGAG-1	aneuploid
ACGATCATCTTGTAAA-1	diploid
ACGATGCATATGTTAT-1	aneuploid
ACGATGGATCCGATGC-1	aneuploid
ACGCAAACTAATAGAT-1	diploid
ACGCAATCACTACAGC-1	diploid
ACGCATAAATGACATG-1	aneuploid
ACGCATACGTTTACTA-1	diploid
ACGCATTCGTGAGTAC-1	aneuploid
ACGCCACTCGAAACAG-1	diploid
ACGCCAGATGATTTCT-1	aneuploid
ACGCCAGTGCGTTTGC-1	diploid
ACGCCCAGCTGTCGAT-1	aneuploid
ACGCCGCTAGACGACC-1	diploid
ACGCCTGACACGCGCT-1	aneuploid
ACGCGAAGTCAGACGA-1	diploid
ACGCGCTACACAGGGT-1	aneuploid
ACGCGGGCCAAGGACA-1	aneuploid
ACGCTAGTATCAGTGC-1	aneuploid
ACGCTAGTGATACACT-1	diploid
ACGCTTAGTGTCTCTC-1	aneuploid
ACGGAACACGAGTGCC-1	diploid
ACGGAATTTAGCAAAT-1	aneuploid
ACGGACGCAGCGACAA-1	diploid
ACGGACTCTCAAAGCG-1	diploid
ACGGAGCGCAAATTAC-1	diploid
ACGGATGGTGCGGATA-1	diploid
ACGGCACTTGCTTGGG-1	diploid
ACGGCCAACATGGACT-1	diploid
ACGGCGACGATGGGAA-1	diploid
ACGGCGGGTTGCCCTG-1	aneuploid
ACGGCTGGATGTAGAA-1	diploid
ACGGGAGTGTCGGCCC-1	aneuploid
ACGGGCGTATGCGACA-1	diploid
ACGGGTCATGTGACTT-1	aneuploid
ACGGGTTGTGACCTGT-1	diploid
ACGGTACAGTTCAATG-1	diploid
ACGGTCACCGAGAACA-1	diploid
ACGTACAGATTTCTCT-1	aneuploid
ACGTACTTTGGCACGG-1	diploid
ACGTAGATTGCTGATG-1	aneuploid
ACGTAGGAGAGTCGCT-1	diploid
ACGTATTACTCCGATC-1	diploid
ACGTCCTAAACGAGAT-1	aneuploid
ACGTCGGGCAACTCGG-1	diploid
ACGTCTCGTTCCGGGA-1	aneuploid
ACGTGACAAAGTAAGT-1	diploid
ACGTGCGCCTCGTGCA-1	aneuploid
ACGTGGTCGAATGTGC-1	aneuploid
ACGTTAATGTCGAAGA-1	diploid
ACGTTAGATTTGCCCG-1	aneuploid
ACGTTATTGGTCACTC-1	aneuploid
ACGTTCACTATGCCGC-1	diploid
ACGTTCCGCGCTCCGT-1	aneuploid
ACGTTCGCAATCAATT-1	diploid
ACGTTCGTTCAGGAAA-1	diploid
ACGTTCTGTACAAGTC-1	diploid
ACGTTGTCGTTGAAAG-1	diploid
ACGTTTAGTTGTGATC-1	aneuploid
ACGTTTCGGTGCACTT-1	diploid
ACTAAGGACGCACACC-1	diploid
ACTAATACGTCAGGCG-1	aneuploid
ACTACAAAGAGAGGTG-1	diploid
ACTACATCCCGACAAG-1	diploid
ACTACCAGCTCTCTGG-1	aneuploid
ACTACCATCCGAGGGC-1	diploid
ACTACGCGTTAGAATT-1	diploid
ACTAGTTGCGATCGTC-1	diploid
ACTATATGCTGTGTTC-1	aneuploid
ACTATCCAGGGCATGG-1	diploid
ACTATCGCCGGCTAAA-1	aneuploid
ACTATCTGCCCGCGTA-1	diploid
ACTATGTCCAGCTGCC-1	diploid
ACTATTCGTCCGTGGT-1	aneuploid
ACTATTTCCGGGCCCA-1	diploid
ACTCAACGAATGTATT-1	aneuploid
ACTCAAGTGCAAGGCT-1	diploid
ACTCAATAAAGGCACG-1	aneuploid
ACTCAGACCTGCTTCT-1	aneuploid
ACTCATGGCAGCCTTC-1	diploid
ACTCCAATATCATCAT-1	diploid
ACTCCCATTCCTAAAG-1	aneuploid
ACTCCCGAATTCGTTT-1	diploid
ACTCCCGTAGACTAGG-1	diploid
ACTCCCTAATGCTAAA-1	diploid
ACTCCCTAGAATAGTA-1	diploid
ACTCCGGCCGACCACT-1	diploid
ACTCGATGTATTTCAT-1	aneuploid
ACTCGCCGTTCGATAA-1	diploid
ACTCGTAACCCGTCCT-1	aneuploid
ACTCTAAACCTGGGAT-1	aneuploid
ACTCTCTGACTTAGGT-1	diploid
ACTCTCTTATACACGA-1	aneuploid
ACTCTGACCTAATAGA-1	diploid
ACTCTTCAGCTCCCGC-1	diploid
ACTGAAACGCCGTTAG-1	diploid
ACTGAATGGCGAAAGT-1	diploid
ACTGATTTAGTGATTC-1	aneuploid
ACTGCCCGCCATTCTC-1	diploid
ACTGCCGTCGTAACTC-1	aneuploid
ACTGCGGACACACCGT-1	diploid
ACTGCTCGGAAGGATG-1	diploid
ACTGGCGAACCTGCGT-1	aneuploid
ACTGGGATGCCAGTGC-1	diploid
ACTGTACGATACACAT-1	diploid
ACTGTAGCACTTTGGA-1	aneuploid
ACTGTATACGCGAGCA-1	aneuploid
ACTGTCCAGGATTATA-1	aneuploid
ACTGTCTTCTTTAGAA-1	aneuploid
ACTGTGCTAGTAGATC-1	aneuploid
ACTTACCGGGCGCGCA-1	diploid
ACTTACGCATCCACGC-1	diploid
ACTTAGTACGACAAGA-1	aneuploid
ACTTATACTTACCCGG-1	diploid
ACTTATCTGATCTATA-1	aneuploid
ACTTATTAGGATCGGT-1	diploid
ACTTATTTATGTGCCA-1	diploid
ACTTCCAGTGGAAGCT-1	diploid
ACTTCCATGCGGGACA-1	diploid
ACTTCCTGTCGTGCGA-1	aneuploid
ACTTCGCCATACGCAC-1	aneuploid
ACTTCGCTAGCGAGTG-1	diploid
ACTTGACTCCCTCTTT-1	diploid
ACTTGCCATATTGTAC-1	aneuploid
ACTTGCTCTATCTACC-1	diploid
ACTTGGGACCCGGTGG-1	aneuploid
ACTTGTAGTCCCTTCA-1	aneuploid
ACTTGTGGATGGAACG-1	diploid
ACTTGTTACCGGATCA-1	diploid
ACTTTACCCTCATGAA-1	diploid
ACTTTCCTATAGCTTC-1	aneuploid
ACTTTGGTCGTGCTCC-1	diploid
ACTTTGTCGACGCACT-1	diploid
AGAAATTATGACTCGC-1	diploid
AGAACACGGCGATGGT-1	diploid
AGAACCCAGCGTGACA-1	diploid
AGAACCCTCAATTGGG-1	diploid
AGAACGTGGTACATTC-1	aneuploid
AGAACTGTACTTTGTA-1	diploid
AGAAGGTACACTTCAC-1	diploid
AGAAGGTTGCCGAATT-1	diploid
AGAAGGTTGTAGGTCG-1	diploid
AGAAGTGATTCGTGAT-1	aneuploid
AGAATACAGGCTATCC-1	diploid
AGAATGCGGGTTCGGA-1	aneuploid
AGAATTATGGATTCGA-1	diploid
AGAATTGTTTGACATA-1	aneuploid
AGACAGCTCAGAATCC-1	aneuploid
AGACATAGATCCTTCC-1	aneuploid
AGACCAAACCACACCT-1	diploid
AGACCATGGGATACAA-1	aneuploid
AGACCCACCGCTGATC-1	diploid
AGACCCGCCCTCCTCG-1	aneuploid
AGACCGCTCCGCGGTT-1	diploid
AGACCGGGAAACCCTG-1	aneuploid
AGACGAAGTGCCGGTC-1	diploid
AGACGCCCACTTCGCC-1	diploid
AGACGGGATTGGTATA-1	aneuploid
AGACGGGCCGATTTAA-1	aneuploid
AGACTAGCCTTCCAGA-1	aneuploid
AGACTGTTACCGGGTC-1	diploid
AGAGAAACACCAGAAA-1	diploid
AGAGAACCGTCTAGGA-1	aneuploid
AGAGAAGGAGTACAAT-1	diploid
AGAGATCTCTAAAGCG-1	aneuploid
AGAGCAGTTATGAGAC-1	aneuploid
AGAGCCGCCGAGATTT-1	diploid
AGAGCGCTTGTAACGG-1	diploid
AGAGCGGGCTAATCAT-1	aneuploid
AGAGCGTACAAGCTCG-1	aneuploid
AGAGCTACGAAAGCAT-1	diploid
AGAGGCTTCGGAAACC-1	diploid
AGAGGGACAATTGTCC-1	aneuploid
AGAGGTATCTCGGTCC-1	aneuploid
AGAGTAAACTTCACTA-1	diploid
AGAGTATAGTGTTACG-1	diploid
AGAGTGAACAGACACC-1	aneuploid
AGAGTTAGAGACCGAT-1	aneuploid
AGAGTTGCAGGCCTCC-1	aneuploid
AGATAACTTCAGGGCC-1	aneuploid
AGATAATCACACCTAT-1	diploid
AGATACCAATAGAACC-1	diploid
AGATACCAGCACTTCA-1	diploid
AGATACCGGTGTTCAC-1	aneuploid
AGATACGACTTCATAT-1	aneuploid
AGATACTCAAGATCGA-1	diploid
AGATATAATACGACTA-1	diploid
AGATCGTGCATAAGAT-1	aneuploid
AGATCTCAGGTGTGAT-1	diploid
AGATCTGGAGAGGATA-1	diploid
AGATGACTCGCCCACG-1	aneuploid
AGATGAGGGTTGCGAT-1	aneuploid
AGATGATGGAGTCTGG-1	diploid
AGATGCAAGACGTGCA-1	diploid
AGATGCATCCTGTGTC-1	diploid
AGATGCTATAACGAGC-1	aneuploid
AGATTATAGGACGTTT-1	aneuploid
AGATTCAAGCGGGTCG-1	aneuploid
AGATTCACAACCGATA-1	diploid
AGCAAAGGCCGCTAGT-1	diploid
AGCAACATATCTTATT-1	diploid
AGCAACCGAAAGTAAT-1	diploid
AGCACCAGTACTCACG-1	aneuploid
AGCACTACCGGCCTGT-1	aneuploid
AGCACTACCTCACCAG-1	diploid
AGCACTTAAGGACGCC-1	aneuploid
AGCAGAAGGAGAAAGA-1	diploid
AGCAGCCAGATGAATA-1	diploid
AGCAGTCGAAGCATGC-1	diploid
AGCATATCAATATGCT-1	diploid
AGCATCATTTCGAAAG-1	diploid
AGCATCGTCGATAATT-1	aneuploid
AGCATTACGAGGCAAG-1	diploid
AGCCAAGCTTTGTGTC-1	diploid
AGCCACAGGTTACCCG-1	diploid
AGCCACTCCCGTGCTT-1	aneuploid
AGCCATATAGTATGTG-1	diploid
AGCCCATACATGTAAG-1	aneuploid
AGCCCGCAACAAGCAG-1	diploid
AGCCCGCACTACAATG-1	diploid
AGCCCGGCATTAGAGG-1	diploid
AGCCCTAAGCGAAGTT-1	aneuploid
AGCCCTGTCGCACCGT-1	diploid
AGCCCTTCTAATCCGA-1	aneuploid
AGCCCTTGGACATCCC-1	diploid
AGCCGCAAATTCAAAT-1	aneuploid
AGCCGCTTGATTAGCG-1	aneuploid
AGCCGTGGCTAAATGT-1	diploid
AGCCTAATACCCACGT-1	diploid
AGCCTTAAAGCGGAAG-1	aneuploid
AGCCTTGTCACTGATA-1	diploid
AGCGACAGGAACGGTC-1	diploid
AGCGACATCCCATTCA-1	aneuploid
AGCGACCAACGATATT-1	aneuploid
AGCGAGACGTGAAGGC-1	diploid
AGCGATGCGCCTAATA-1	diploid
AGCGCATAATGAATCG-1	diploid
AGCGCGGGTGCCAATG-1	aneuploid
AGCGCTAGAGCGATGT-1	diploid
AGCGCTTATGGGCAAG-1	aneuploid
AGCGGACACTTCGTAG-1	diploid
AGCGGCGGTTAGCGGT-1	diploid
AGCGGGAAGGGTCCAT-1	aneuploid
AGCGGGTCTGACACTC-1	diploid
AGCGGTTGAGATGTAC-1	aneuploid
AGCGGTTGCCGCTCTG-1	diploid
AGCGTACGAGAGCTAG-1	aneuploid
AGCGTAGCGCTAGACC-1	aneuploid
AGCGTCTGAACCCGCA-1	aneuploid
AGCGTGGTATTCTACT-1	diploid
AGCGTTCCGATTTAAA-1	aneuploid
AGCTAACAAGCAATGT-1	diploid
AGCTAAGTACGCAGGC-1	diploid
AGCTAGAAGCAGAAGT-1	diploid
AGCTATTTAATCCAAC-1	aneuploid
AGCTCCATATATGTTC-1	diploid
AGCTCCTTCGCACATC-1	diploid
AGCTCGTTGATGGAAA-1	diploid
AGCTCTAGACGTTCCA-1	diploid
AGCTCTTCCCAGTGCA-1	aneuploid
AGCTCTTCGTAACCTT-1	diploid
AGCTCTTTACTCAGTT-1	diploid
AGCTGAAGTAAACCAA-1	aneuploid
AGCTGCATTTGAGGTG-1	aneuploid
AGCTGCTGTGCCGAAT-1	aneuploid
AGCTGTAACCTCAATC-1	diploid
AGCTTATAGAGACCTG-1	aneuploid
AGCTTCAATACTTTGA-1	aneuploid
AGCTTCTTCTCGAGCA-1	diploid
AGCTTGATCAGGGTAG-1	diploid
AGCTTGATCTTAACTT-1	aneuploid
AGGAAAGCCTCTGATG-1	aneuploid
AGGAACGAACGACTTC-1	diploid
AGGAAGCTGTCCGCCG-1	diploid
AGGACAGTCGAATCCC-1	diploid
AGGACATCGCACGTCG-1	aneuploid
AGGACATCGGCACACT-1	diploid
AGGACGACCCATTAGA-1	diploid
AGGACGCTCGATGTTG-1	aneuploid
AGGACTTATAGGAGAA-1	aneuploid
AGGAGACATCCACAGT-1	diploid
AGGAGAGTCTGGCTAC-1	diploid
AGGAGGCCTTCGCGCG-1	diploid
AGGATAAAGTCGGGAT-1	diploid
AGGATATAGGGATTTA-1	diploid
AGGATATCCGACTGCA-1	diploid
AGGATCACGCGATCTG-1	diploid
AGGATTGCTTACGACA-1	diploid
AGGCAAAGAGGAATCA-1	aneuploid
AGGCAATACGGAGGAC-1	aneuploid
AGGCACGTGACTGTCC-1	diploid
AGGCAGATGCGTAAAC-1	aneuploid
AGGCAGGGAGCGTACT-1	diploid
AGGCATTGTCGTAGGG-1	diploid
AGGCCACCCGTTATGA-1	aneuploid
AGGCCCAGTGACTGGT-1	aneuploid
AGGCCCATTGTACAGG-1	aneuploid
AGGCCCTAGAACGCCA-1	aneuploid
AGGCCTATCATACCAA-1	diploid
AGGCCTGAGAATCTCG-1	diploid
AGGCGATAACTGGCGT-1	diploid
AGGCGGTTTGTCCCGC-1	diploid
AGGCGTCTATGGACGG-1	diploid
AGGCTATGGTTAGCTT-1	aneuploid
AGGCTTAAGTTGCACA-1	diploid
AGGCTTGCTAGACACC-1	aneuploid
AGGGAAACGAGGTACT-1	aneuploid
AGGGACAGCACGGCGG-1	aneuploid
AGGGACCGGCTGCGTT-1	diploid
AGGGACTCTACGCGAC-1	diploid
AGGGAGACATACTTCG-1	diploid
AGGGCAGCGGCGTGGT-1	aneuploid
AGGGCCCTAATGTTCT-1	diploid
AGGGCGAGCAGCTGAT-1	aneuploid
AGGGCGTGATCGGCTA-1	aneuploid
AGGGCTGCAGTTACAG-1	diploid
AGGGTCAGAGCACTCG-1	diploid
AGGGTCAGTAACCCTA-1	diploid
AGGGTCGATGCGAACT-1	diploid
AGGGTCTGGACGCAGT-1	diploid
AGGGTGCCGTTCTTTA-1	diploid
AGGGTGCTCTCGAGGG-1	diploid
AGGGTGGATAGTGCAT-1	aneuploid
AGGGTGTGCTACACGC-1	aneuploid
AGGGTTCAGACGGTCC-1	diploid
AGGGTTCCCTTTGGTT-1	diploid
AGGGTTTAGTTCGGGA-1	aneuploid
AGGTAACCTCCTATTC-1	aneuploid
AGGTACGATATTGCCA-1	aneuploid
AGGTAGATCGAGATAT-1	diploid
AGGTAGGTACAAAGCT-1	aneuploid
AGGTATAATTGATAGT-1	diploid
AGGTATGCGGACATTA-1	diploid
AGGTCAGGTGAGAGTG-1	aneuploid
AGGTCGCCACTTCGGT-1	aneuploid
AGGTCGCCTCCCAACA-1	diploid
AGGTCGCGGAGTTACT-1	diploid
AGGTGCACGTCCACAT-1	diploid
AGGTGGTGACCTTCGC-1	diploid
AGGTGTATCGCCATGA-1	aneuploid
AGGTTACACCATGCCG-1	diploid
AGGTTCTCCTTTCCGG-1	diploid
AGGTTGAGGCACGCTT-1	aneuploid
AGGTTTCACACACCTT-1	diploid
AGTAACGTTCATCCTG-1	aneuploid
AGTAACTATAGCAGCC-1	diploid
AGTAATCTAAGGGTGG-1	diploid
AGTAATGTCTTGCCGC-1	aneuploid
AGTAATTTGCAAGCGT-1	diploid
AGTACAGAAGCTTATA-1	diploid
AGTACATCATTTATCA-1	diploid
AGTACCTTCGAGTGCT-1	aneuploid
AGTACGGCCCGTATCG-1	aneuploid
AGTACGGGCACCTGGC-1	aneuploid
AGTACGTGGCCTGTCT-1	aneuploid
AGTACTCTTATGCCCA-1	diploid
AGTAGAAGGCGCCTCA-1	diploid
AGTAGCGTGAACGAAC-1	aneuploid
AGTAGCTAGACGCCGA-1	aneuploid
AGTAGGAAGGAAGTTG-1	aneuploid
AGTAGGTAACATACAT-1	aneuploid
AGTATAATACTAGGCA-1	aneuploid
AGTATACACAGCGACA-1	diploid
AGTATCCATAATAACG-1	aneuploid
AGTATGCTGGAGACCA-1	diploid
AGTATTTGGCACGACC-1	diploid
AGTCAAATGATGTGAT-1	diploid
AGTCAACACCACCATC-1	diploid
AGTCAAGATGACACTT-1	diploid
AGTCACTAGCTCTCGA-1	diploid
AGTCACTCCGCCTCAT-1	aneuploid
AGTCAGCCACCGCCTG-1	aneuploid
AGTCCATTGGCTGATG-1	diploid
AGTCCCGCCTTTAATT-1	aneuploid
AGTCCCTCGCAGAAAG-1	diploid
AGTCGAAACGATTCAG-1	diploid
AGTCGACGGTCTCAAG-1	diploid
AGTCGGCCCAAACGAC-1	aneuploid
AGTCGGCTCAACTTTA-1	aneuploid
AGTCGGTTGCGTGAGA-1	diploid
AGTCGTATAAAGCAGA-1	diploid
AGTCGTCGACCACCAA-1	diploid
AGTCGTGGGCATTACG-1	diploid
AGTCTAAAGTATACTC-1	diploid
AGTCTCACAAGACTAC-1	diploid
AGTCTGGACATCCTTG-1	aneuploid
AGTCTTCTCCTCAAAT-1	aneuploid
AGTCTTTAAAGTGTCC-1	diploid
AGTGAACAAACTTCTC-1	diploid
AGTGAAGATGGTGTCC-1	diploid
AGTGACTGTGACACAA-1	diploid
AGTGAGACTTCCAGTA-1	diploid
AGTGAGCCTCGCCGCC-1	diploid
AGTGAGGGTTTCTGAC-1	aneuploid
AGTGAGTCGAATTAAC-1	diploid
AGTGATAACCTGCGCG-1	diploid
AGTGATATGAGTAGTT-1	diploid
AGTGATTCAAGCAGGA-1	diploid
AGTGCACGCTTAAGAA-1	diploid
AGTGCGTAGCTCGTAA-1	diploid
AGTGCTAAACACAGCA-1	diploid
AGTGCTTGCACGAATA-1	diploid
AGTGGCCCGCAAATGG-1	diploid
AGTGGCGGCAATTTGA-1	aneuploid
AGTGGCGTCTGAAGGT-1	diploid
AGTGGCTCCGTCGGCC-1	aneuploid
AGTGGGAGTATACACG-1	aneuploid
AGTGGTGTTACCCGTG-1	diploid
AGTGGTTGCGTATAGG-1	aneuploid
AGTGTATTGCGCATTG-1	aneuploid
AGTGTGCTAAGATCGC-1	aneuploid
AGTGTGGTCTATTGTG-1	aneuploid
AGTTAAACACTTGCGA-1	diploid
AGTTAAGCGGTCCCGG-1	aneuploid
AGTTAAGTCAACCGCT-1	diploid
AGTTACCCTTAAGACT-1	aneuploid
AGTTACCGCACATGGT-1	aneuploid
AGTTACTCTATCGTGG-1	aneuploid
AGTTATTGAAAGGTAA-1	aneuploid
AGTTCACCGGTTGGAC-1	aneuploid
AGTTCCTACAGAATTA-1	aneuploid
AGTTCCTATTTATGTT-1	diploid
AGTTCTGCGTTGTATC-1	aneuploid
AGTTGACATCGGCTGG-1	aneuploid
AGTTGACGGTCCTTGC-1	diploid
AGTTGCGGTCCTCAAC-1	diploid
AGTTGCTGACTGATAT-1	aneuploid
AGTTGGCAAGGCTAGA-1	diploid
AGTTTATGTAAAGACA-1	diploid
AGTTTCGCAGGTCGGA-1	aneuploid
AGTTTGGCACGGGTTG-1	diploid
AGTTTGGCCAGACCTA-1	aneuploid
ATAAACCATTGGACGG-1	aneuploid
ATAAACGGACCCGTAA-1	diploid
ATAAACGTTGCACCAC-1	diploid
ATAAAGGCTCGGTCGT-1	aneuploid
ATAAAGGTCAAGTACG-1	aneuploid
ATAAATATTAGCAGCT-1	aneuploid
ATAACGGAGTCCAACG-1	aneuploid
ATAACGTTACCTCCAC-1	aneuploid
ATAAGCAAACACCGAG-1	aneuploid
ATAAGGTGGAGAACAT-1	diploid
ATAAGTACCCGATTGT-1	aneuploid
ATAAGTAGGATTCAGA-1	diploid
ATAAGTAGGGCGACTC-1	diploid
ATAAGTTACCGCGACG-1	diploid
ATAATACCGTTAGCCG-1	aneuploid
ATAATAGCTGTTGAAT-1	diploid
ATAATAGTGTAGGGAC-1	aneuploid
ATAATCTTGGAGAACC-1	diploid
ATAATTAGCTAAGTAG-1	diploid
ATACAGCGTCCACTGA-1	diploid
ATACAGGCCCTCCAAT-1	diploid
ATACCACGGGCAACTT-1	aneuploid
ATACCAGCAAATTGCT-1	diploid
ATACCAGGCTAATAGA-1	aneuploid
ATACCAGGTGAGCGAT-1	diploid
ATACCCTCCCGGCCAA-1	diploid
ATACCCTGGCTCAAAT-1	aneuploid
ATACCGTCATCCATAA-1	diploid
ATACCTAACCAAGAAA-1	diploid
ATACGAAGGCTTTCCA-1	diploid
ATACGACAGATGGGTA-1	aneuploid
ATACGAGGTTTGTAAG-1	diploid
ATACGCCGATCTACCG-1	aneuploid
ATACGCCGGCGAAACC-1	diploid
ATACGGAACGTCGTTT-1	diploid
ATACGGGTTTCGATTG-1	aneuploid
ATACGGTGAAGATGCA-1	aneuploid
ATACGTACTTAGCCAC-1	diploid
ATACGTCCACTCCTGT-1	diploid
ATACGTTATGCACGGA-1	diploid
ATACTACCCGTACCAC-1	diploid
ATACTAGCATGACCCT-1	aneuploid
ATACTCTCGCCACTCT-1	aneuploid
ATACTGCCTTACACCG-1	diploid
ATACTTGTTCTCGAGC-1	aneuploid
ATAGACAACGGGACCT-1	diploid
ATAGACGAAGAGAAAG-1	aneuploid
ATAGAGTACTGGGACA-1	aneuploid
ATAGAGTTATCAACTT-1	diploid
ATAGATTTGCAGTCGG-1	aneuploid
ATAGCAACTAGGGAAG-1	diploid
ATAGCCATAACAGTCA-1	diploid
ATAGCCTCAGTACCCA-1	aneuploid
ATAGCTGCTCTTGTTA-1	aneuploid
ATAGGAATCTAAGCTT-1	aneuploid
ATAGGCGGCTATAGAA-1	aneuploid
ATAGGCTAGCTTCGCA-1	diploid
ATAGGGATATCCTTGA-1	aneuploid
ATAGGTTGGGCAGATG-1	aneuploid
ATAGTCTTTGACGTGC-1	aneuploid
ATAGTTCCACCCACTC-1	diploid
ATATAAAGCGCTCGTG-1	diploid
ATATAACACGGGCGCA-1	diploid
ATATACATGTATGGTA-1	diploid
ATATACGCTCGTGACG-1	diploid
ATATAGAGTATTGGTC-1	diploid
ATATCAACCTACAGAG-1	diploid
ATATCAATTCCAGCCT-1	diploid
ATATCGGTAGGGAGAT-1	diploid
ATATCGTGCCAGACCC-1	aneuploid
ATATCGTTCCTCGAAC-1	diploid
ATATCTCCCTCGTTAA-1	aneuploid
ATATCTTAGGGCCTTC-1	diploid
ATATGGGATAGCAACT-1	diploid
ATATGTCTAGAGCGTG-1	diploid
ATATGTCTCCCTAGCC-1	diploid
ATATGTGCACAAACCA-1	aneuploid
ATATTATCCCGTATTT-1	aneuploid
ATATTCAGTTAAACCT-1	diploid
ATATTCCCACAGGTCA-1	aneuploid
ATATTGCTGTCAAAGT-1	aneuploid
ATATTGGAGAGGCCTT-1	diploid
ATATTTAACCCTCAAG-1	aneuploid
ATCAAACACTGTTCCA-1	diploid
ATCAAACGAAGGTTTG-1	diploid
ATCAAAGAGCCGTGGT-1	diploid
ATCAAGATCCCAGGAC-1	diploid
ATCAATCTGGGCTGCA-1	aneuploid
ATCAATGCCGTGGCTG-1	diploid
ATCACATTAGAATATC-1	aneuploid
ATCACGTGCTAATTAA-1	aneuploid
ATCACTTCATCCTCGC-1	aneuploid
ATCAGAAGCTGGTTGC-1	diploid
ATCAGACGGCACGCCG-1	diploid
ATCAGCCTCATGCTGC-1	diploid
ATCAGCTCGTCCACTA-1	diploid
ATCAGGTAGCTGACAG-1	diploid
ATCAGGTCGCCATTGC-1	aneuploid
ATCAGTAGGCAGGGAT-1	aneuploid
ATCATAGATCGACGAG-1	diploid
ATCATAGCCCTATGTA-1	diploid
ATCATCTGCCCAGTGT-1	aneuploid
ATCATTGTACCGCATT-1	diploid
ATCCAACGCAGTCATA-1	aneuploid
ATCCAATGGAGGGTCC-1	aneuploid
ATCCACATCGACAGAA-1	diploid
ATCCACGCTAAATGTT-1	aneuploid
ATCCACTTTCAGACTA-1	aneuploid
ATCCAGAGCAACAACC-1	diploid
ATCCAGGATTCGTGAA-1	aneuploid
ATCCCATCCACAGCGC-1	diploid
ATCCCATTTCCGTGGG-1	diploid
ATCCTACCTAAGCTCT-1	diploid
ATCCTGAATCGCTGCG-1	aneuploid
ATCCTGCGTGGAATGG-1	diploid
ATCCTGCTGCAGATAG-1	aneuploid
ATCGACCCAATACAGA-1	diploid
ATCGACTCTTTCCGTT-1	aneuploid
ATCGCACGATTGTTCA-1	diploid
ATCGCACGCCGGGAGA-1	aneuploid
ATCGCCAGTCAACATT-1	diploid
ATCGCCGTGGTTCATG-1	diploid
ATCGCTGCGTGCAGCA-1	diploid
ATCGCTTTACGTCTCA-1	diploid
ATCGGCAAGCAGTCCA-1	aneuploid
ATCGGTTACCTAGTAA-1	aneuploid
ATCGTATTCCGAGAAC-1	aneuploid
ATCGTCCAATCGAGTC-1	aneuploid
ATCGTGGAAAGTCTGG-1	diploid
ATCGTTAGCTAGCGGA-1	diploid
ATCGTTCACTTTCGCC-1	diploid
ATCTAACGTCCCTATG-1	aneuploid
ATCTACCATCTGCTCC-1	diploid
ATCTAGCTTGTGAGGG-1	diploid
ATCTATCGATGATCAA-1	aneuploid
ATCTCATAAACCTACC-1	aneuploid
ATCTCCCACGGAATAT-1	diploid
ATCTCCCTGCAATCTA-1	aneuploid
ATCTCGTGAGCGAAAC-1	diploid
ATCTGATAGTGTCTTA-1	aneuploid
ATCTGCACCTCTGCGA-1	diploid
ATCTGCTGTTATCGCC-1	diploid
ATCTGGGCTGTTCTTG-1	diploid
ATCTGGTTAAGACTGT-1	aneuploid
ATCTGTAATTGTACCC-1	aneuploid
ATCTTAGGGCATTAAT-1	diploid
ATCTTATCGCACACCC-1	diploid
ATCTTGACCTGCAACG-1	aneuploid
ATCTTGACTTGTCCAA-1	diploid
ATCTTTCGTATAACCA-1	diploid
ATGAAGCCAAGGAGCC-1	aneuploid
ATGAAGTGGACCCAGC-1	aneuploid
ATGACGCCGGCTCTAA-1	aneuploid
ATGACGCGTTCTATCC-1	diploid
ATGACTATCAGCTGTG-1	diploid
ATGACTATGCGACATT-1	diploid
ATGAGGAGTGTTAATC-1	aneuploid
ATGAGGGCAGCGGCTA-1	diploid
ATGATCGGGAATAGAC-1	aneuploid
ATGATGCAATGGTACA-1	diploid
ATGCACCTTCCTTAAT-1	aneuploid
ATGCACGCGCTGTTCA-1	diploid
ATGCACTACCGCATTG-1	aneuploid
ATGCATGATCCAGGAT-1	aneuploid
ATGCATTCCGTGATGG-1	aneuploid
ATGCCAATCGCTCTGC-1	diploid
ATGCCATTTGCGACCA-1	diploid
ATGCCGGTCTTGCATA-1	diploid
ATGCCGGTTGATGGGA-1	aneuploid
ATGCGACAATTGGTCC-1	aneuploid
ATGCGAGTCCCACCAC-1	diploid
ATGCTCAGTGTTGCAT-1	aneuploid
ATGCTCTGGCGCGGTA-1	diploid
ATGCTTAGGAGTTGAT-1	diploid
ATGGAAATTTAAGGAG-1	diploid
ATGGAACAGAATAAAC-1	aneuploid
ATGGAACCTTTGCACA-1	diploid
ATGGACTGCTTAGTTG-1	diploid
ATGGAGCAGGCCGTGA-1	diploid
ATGGATCCGGCGTCCG-1	aneuploid
ATGGATTGACCAAACG-1	aneuploid
ATGGCAGCATTACGAT-1	diploid
ATGGCAGCCGAGAAAC-1	aneuploid
ATGGCCCGAAAGGTTA-1	diploid
ATGGCGGAATAGTCGC-1	diploid
ATGGCTGGAAATGGCC-1	aneuploid
ATGGGAACGGAAGCGG-1	aneuploid
ATGGGACCTGCTGAAC-1	diploid
ATGGGCCTCGGCCTCT-1	diploid
ATGGGTGTATACCTCC-1	diploid
ATGGTATTGGGAACCG-1	diploid
ATGGTATTTACTGATT-1	diploid
ATGGTCGCGTGGTTTC-1	diploid
ATGGTTACGAAACATG-1	aneuploid
ATGTAAGGCTGCTCTT-1	diploid
ATGTACATGCGGTGAG-1	diploid
ATGTACGATGACGTCG-1	diploid
ATGTAGCGCGCGTAGG-1	diploid
ATGTCATTTCCCATTG-1	aneuploid
ATGTCTTGTTTGACTC-1	diploid
ATGTGAAAGCCTAATG-1	aneuploid
ATGTGCATCCGACGCA-1	aneuploid
ATGTGGACATCTTGAT-1	diploid
ATGTTACGAGCAATAC-1	aneuploid
ATGTTCCTGCCCACCT-1	aneuploid
ATGTTCGTCGACCCAC-1	aneuploid
ATGTTGATTAGAGACT-1	diploid
ATGTTGTAGTCTGTTT-1	diploid
ATGTTTCGGCCCGGAG-1	diploid
ATGTTTGTAAGATCAT-1	aneuploid
ATTAAACATGCGGACC-1	diploid
ATTAAAGCGGACGAGC-1	aneuploid
ATTAACACCTGAGATA-1	aneuploid
ATTAATACTACGCGGG-1	aneuploid
ATTAATGAACCAGTCG-1	aneuploid
ATTAATTCGGTCACTC-1	aneuploid
ATTACATGTCAGTCTT-1	diploid
ATTACGACTCCACAGT-1	diploid
ATTACGCGCTGGCAGG-1	aneuploid
ATTACGGGCTACGGTT-1	diploid
ATTACTAGCCTCTTGC-1	aneuploid
ATTACTTACTGGGCAT-1	diploid
ATTAGATTCCTCAGCA-1	diploid
ATTAGATTGATAGCGG-1	aneuploid
ATTAGGCGATGCTTTC-1	diploid
ATTATACTTTGCTCGT-1	aneuploid
ATTATAGCTACTTTAC-1	diploid
ATTATCGGAATGTACG-1	diploid
ATTATCTCGACAGATC-1	diploid
ATTATGAGACCCAATT-1	diploid
ATTATGCCATAGGGAG-1	aneuploid
ATTATGCTCAGTATTG-1	aneuploid
ATTATTATGTCCGTCA-1	diploid
ATTATTCAGAGTCACT-1	diploid
ATTCAAAGTACCTGTT-1	aneuploid
ATTCAACCATTTAAGG-1	diploid
ATTCAGATGAATCCCT-1	aneuploid
ATTCAGGACCTATTTC-1	aneuploid
ATTCAGGATCGCCTCT-1	aneuploid
ATTCAGTAGCAGGGTC-1	aneuploid
ATTCATATACTGTCCA-1	diploid
ATTCATCGTTGAGGCA-1	diploid
ATTCCCACATAAACAA-1	aneuploid
ATTCCCGAAGGTACAG-1	diploid
ATTCCTAAGACGTGGA-1	diploid
ATTCCTCCGCCAGTGC-1	aneuploid
ATTCCTTCCAGGCGGT-1	aneuploid
ATTCGACGCCGGGCCT-1	aneuploid
ATTCGCAGAGGACACT-1	diploid
ATTCGCGCCTTGAGAG-1	diploid
ATTCGTGCTATCTCTT-1	diploid
ATTCTCGTCTCTTTAG-1	aneuploid
ATTCTGAGTATGAACT-1	aneuploid
ATTCTTCGTACTTATG-1	aneuploid
ATTGAAGATCTTAGTG-1	aneuploid
ATTGACCGGCGATGAC-1	diploid
ATTGACGTAACTCGGT-1	aneuploid
ATTGATAGCAACGAGA-1	aneuploid
ATTGATCACCACATTT-1	diploid
ATTGATGAGTCCTAAC-1	diploid
ATTGCCTATTAGACCG-1	diploid
ATTGCCTTTATGTTTG-1	diploid
ATTGCGATCAGTAACT-1	diploid
ATTGCTGCTCCTCCAT-1	aneuploid
ATTGGATTACAGCGTA-1	diploid
ATTGGGAATATCTTGG-1	aneuploid
ATTGGGAGTTCTGTAA-1	aneuploid
ATTGGTAGGATCCGCT-1	aneuploid
ATTGGTTGTGCATTAC-1	diploid
ATTGTACAACTCGGCT-1	diploid
ATTGTCGCAATACCTT-1	aneuploid
ATTGTCTGTTTCATGT-1	diploid
ATTGTGACTTCGCTGC-1	aneuploid
ATTGTTCAACGATCCG-1	diploid
ATTTAACTCGTATTAC-1	aneuploid
ATTTACAGTTTACTGG-1	aneuploid
ATTTACTAAGTCCATT-1	diploid
ATTTATACTGGTAAAG-1	diploid
ATTTCATTATTTCGCG-1	aneuploid
ATTTCCGGGTTCTGCG-1	diploid
ATTTGCCTAGTTACGA-1	aneuploid
ATTTGCGCGAGTAGCT-1	diploid
ATTTGGAGATTGCGGT-1	diploid
ATTTGTCTTGGGAGCT-1	diploid
ATTTGTTCCAGGGCTC-1	aneuploid
CAAACCAGGTCTGCAT-1	aneuploid
CAAACCCTCCGGCGGG-1	diploid
CAAACGAGTATCGCAG-1	diploid
CAAACGGTCGCACTTT-1	aneuploid
CAAACGTGGTCTTGCG-1	aneuploid
CAAACTACGATAGAGA-1	aneuploid
CAAACTATTGAGCTTC-1	aneuploid
CAAACTCGCGACGCCG-1	diploid
CAAAGATTATTGGGCC-1	diploid
CAAAGGTTAAATTCAG-1	aneuploid
CAAAGTCAGGTTAGCT-1	aneuploid
CAAATCTCTCACAAGG-1	aneuploid
CAAATGCGGAGTGTTC-1	aneuploid
CAAATGTCCTTCCGTG-1	diploid
CAAATTGGATTATGCC-1	diploid
CAAATTGTCAGCAAGC-1	aneuploid
CAACACATCTCCTGCC-1	diploid
CAACAGAATAACGCTA-1	aneuploid
CAACAGTGCCAAACGG-1	aneuploid
CAACATGGCCTGATAA-1	aneuploid
CAACCAGTGGCCTACC-1	diploid
CAACCTACCGAGCAGT-1	diploid
CAACCTGAACCTGCCA-1	diploid
CAACGACCCGTTTACA-1	aneuploid
CAACGAGCTTATTATG-1	diploid
CAACGCGATGAGCCAA-1	diploid
CAACGGTTCTTGATAC-1	aneuploid
CAACGTGGTGGAGTCT-1	diploid
CAACTATATCGAATGC-1	aneuploid
CAACTCCAACGTTTAG-1	aneuploid
CAACTCCGTAACTTGC-1	aneuploid
CAACTCCTTGATCCCG-1	aneuploid
CAACTGAGGGTATGAC-1	aneuploid
CAACTGCTCATCCGAT-1	diploid
CAACTTGTAGTGGGCA-1	aneuploid
CAAGAAACCCTAAACT-1	aneuploid
CAAGACTCAGAAGCGC-1	diploid
CAAGAGGGCGGAGTAC-1	diploid
CAAGATATTATAACGT-1	diploid
CAAGCAACGTCGGAGT-1	aneuploid
CAAGCACCAAATGCCT-1	aneuploid
CAAGGATCGCATGTTC-1	diploid
CAAGGCCAGTGGTGCA-1	diploid
CAAGGGAGTGTATTTG-1	aneuploid
CAAGGTCCTATAGGCT-1	diploid
CAAGTAAGTGATAGAC-1	diploid
CAAGTGAACTTTGGTT-1	aneuploid
CAAGTGTGGTTGCAAA-1	diploid
CAATAAACCTTGGCCC-1	aneuploid
CAATACGAGAGTCTGA-1	diploid
CAATACGCTCTGAGGC-1	aneuploid
CAATATGTAGATTTAC-1	aneuploid
CAATATTCTTGACCTA-1	diploid
CAATATTGGACTAGTG-1	aneuploid
CAATCCATTATCCGTT-1	aneuploid
CAATCCCTATACCAGC-1	aneuploid
CAATCCTGCCGTGGAG-1	aneuploid
CAATGACCCTTAATTT-1	diploid
CAATGAGGTTCGACTA-1	diploid
CAATGCGAGAAGTATC-1	diploid
CAATGGAATCTACATA-1	aneuploid
CAATGGATCTCTACCA-1	diploid
CAATGGTCGGCCTGGG-1	aneuploid
CAATGTGCCAACCCTT-1	diploid
CAATTAAGGGTGATGA-1	aneuploid
CAATTGGGCCGCACTC-1	diploid
CAATTTCGTATAAGGG-1	diploid
CAATTTGACCGGGAAG-1	aneuploid
CACAAACCGCAGAACT-1	diploid
CACAAGAAAGATATTA-1	aneuploid
CACAAGCTAAGAAAGG-1	diploid
CACAATGAGCTGCTAT-1	diploid
CACACACGCTAACGAG-1	diploid
CACACAGCTTGCGCTC-1	diploid
CACACAGGGATAGATT-1	aneuploid
CACACGCGCTGTCTTA-1	diploid
CACACGTTTCAATGGG-1	aneuploid
CACACTTGTATTGCGA-1	aneuploid
CACAGAGACGAGGACG-1	diploid
CACAGCACCCACGGCA-1	aneuploid
CACAGCTAGGGAGTGA-1	aneuploid
CACAGGGCCATATAGT-1	diploid
CACAGGGCCGTTGTCA-1	diploid
CACAGTCCCGCTTCGC-1	diploid
CACAGTTCGCTTCCCA-1	diploid
CACATAAGGCGACCGT-1	aneuploid
CACATATTAGCAGGAT-1	diploid
CACATCGTGCACGCGC-1	diploid
CACATGATTCAGCAAC-1	diploid
CACATGTTTGGACATG-1	diploid
CACATTCTTTCGATGG-1	aneuploid
CACATTTCTTGTCAGA-1	diploid
CACCAATCATCCGTCT-1	diploid
CACCACGCCACACAGA-1	aneuploid
CACCAGTCAGCATGCA-1	diploid
CACCATCGGAGGAGAC-1	aneuploid
CACCATGATCGCAAAG-1	aneuploid
CACCCAAATCTTATGT-1	diploid
CACCCACACGTCACCC-1	aneuploid
CACCCACGAGGCAATT-1	aneuploid
CACCCGCGTTTGACAC-1	diploid
CACCCGGTTTGTGACT-1	diploid
CACCCTAACAAGATCT-1	diploid
CACCCTTGGTGAGACC-1	diploid
CACCCTTTCCTCGCTC-1	aneuploid
CACCGATACACCGAGC-1	aneuploid
CACCGATGATGGGTAC-1	diploid
CACCGCCAGAAGGTTT-1	aneuploid
CACCGCCGACCAGCGA-1	aneuploid
CACCGCGTCCACTCTA-1	aneuploid
CACCGGAGATATCTCC-1	aneuploid
CACCGGGCATCACAAG-1	diploid
CACCGGTAGAGACATT-1	diploid
CACCGTATCCCATCCG-1	diploid
CACCGTTGCGCGATAT-1	aneuploid
CACCTAATAGAGTCGT-1	aneuploid
CACCTAATCAGTTTAC-1	aneuploid
CACCTCGATGGTGGAC-1	aneuploid
CACCTCTACGAGTGTG-1	aneuploid
CACCTTGCGAAACTCG-1	aneuploid
CACCTTGGCGCCTTTG-1	diploid
CACGAAAGTTAGTCCC-1	aneuploid
CACGACCACAGACTTT-1	aneuploid
CACGACGTAATAGTAA-1	aneuploid
CACGACTAAAGTTCTG-1	aneuploid
CACGAGCAAACCAGAC-1	diploid
CACGATTGGTCGTTAA-1	aneuploid
CACGCACAGCGCAGCT-1	aneuploid
CACGCAGCGAGGCTTT-1	aneuploid
CACGCGGAACTGTTGC-1	diploid
CACGGACGTGGATGGC-1	diploid
CACGGCGCGCCAAAGG-1	aneuploid
CACGGGATTGAGGGTT-1	aneuploid
CACGTCAATCAATGGA-1	diploid
CACGTCGGCAACCTCT-1	diploid
CACGTCGGGTTCTAGA-1	aneuploid
CACGTCTATGATGTGG-1	aneuploid
CACGTTCGTGCTCTAG-1	aneuploid
CACGTTTCGTACACAC-1	diploid
CACTAAAGTTGCCTAT-1	aneuploid
CACTACGGGAGCTGCC-1	diploid
CACTACTCAGTTCTGT-1	aneuploid
CACTCAAGAGCTATGG-1	diploid
CACTCAGCTCTTGAGG-1	aneuploid
CACTCCTATGTAAGAT-1	diploid
CACTCCTCTCGGTCGG-1	aneuploid
CACTCGAGCTGAACAA-1	diploid
CACTCGGTTAGGAGGA-1	aneuploid
CACTCTCAAGCATCGA-1	diploid
CACTCTTCTGCTAGCC-1	diploid
CACTGACGATTGTGGA-1	diploid
CACTGTCCAAGTGAGA-1	aneuploid
CACTTAATCAGACGGA-1	aneuploid
CACTTCGCCACAGGCT-1	aneuploid
CACTTCGTCTTATCTC-1	aneuploid
CAGAACTTAGCCCTCT-1	diploid
CAGAATAACACACGGA-1	diploid
CAGAATATTCGTTATC-1	diploid
CAGACACCGATCGCTG-1	diploid
CAGACCTGTAAGTGTT-1	aneuploid
CAGACGAACCTGATAC-1	diploid
CAGAGACGGTCACCCA-1	diploid
CAGAGCATGAGCTTGC-1	aneuploid
CAGAGCGATGGATGCT-1	diploid
CAGAGGCGATGCATGA-1	diploid
CAGAGTGATTTAACGT-1	aneuploid
CAGATAATGGGCGGGT-1	diploid
CAGATACTAACATAGT-1	aneuploid
CAGATATGAAGATGAC-1	diploid
CAGATCATTTAAAGTC-1	diploid
CAGATCCTGGTTTGAA-1	diploid
CAGATGTTTGTCCCAA-1	diploid
CAGCAGCCCGTTCCTT-1	diploid
CAGCAGTCCAGACTAT-1	diploid
CAGCAGTCTGTGCTGC-1	diploid
CAGCCCTCACAGGCAG-1	aneuploid
CAGCCTCCTGCAGAGG-1	aneuploid
CAGCCTCTCCTCAAGA-1	aneuploid
CAGCGATTCCCTTCAA-1	diploid
CAGCGCCAACACGATA-1	aneuploid
CAGCTCACTGAGACAT-1	aneuploid
CAGCTCGACAAGTTAA-1	diploid
CAGCTCGTGCTTGTGT-1	aneuploid
CAGCTCTGGGCTCACT-1	diploid
CAGCTGGCGTAACCGT-1	aneuploid
CAGCTTAGTAGGTAGC-1	aneuploid
CAGGAAGACTTTATAT-1	aneuploid
CAGGACAGCTGCCCTT-1	diploid
CAGGATATATCGTTGT-1	diploid
CAGGATCCGCCCGACC-1	aneuploid
CAGGCAGTCTTACCAG-1	diploid
CAGGCCGTTTGGGTGT-1	diploid
CAGGCGCACGGTGGTC-1	diploid
CAGGCGCCATGCTAGG-1	diploid
CAGGGAGATAGGCCAG-1	diploid
CAGGGCTAACGAAACC-1	aneuploid
CAGGTTTAGTACTACA-1	diploid
CAGTAACTATTTATTG-1	aneuploid
CAGTAAGGGACGTCTC-1	diploid
CAGTAATCCCTCCCAG-1	aneuploid
CAGTACATTCTCTAAA-1	diploid
CAGTACCAGTTTACGT-1	diploid
CAGTAGATGATGTCCG-1	aneuploid
CAGTAGCCCACGCGGT-1	aneuploid
CAGTAGCGAGGTAGTA-1	aneuploid
CAGTCCAACGCCTTCT-1	aneuploid
CAGTCGAGGATGCAAT-1	diploid
CAGTCGGCCTAGATAT-1	aneuploid
CAGTCTCTCGGCTAAT-1	aneuploid
CAGTCTGTATACTGGG-1	diploid
CAGTGAATAAATGACT-1	aneuploid
CAGTGGTTGCACATGA-1	aneuploid
CAGTGTCCGCAGAATG-1	aneuploid
CAGTGTCGGCTGGCCC-1	diploid
CAGTGTTAATCTCTCA-1	diploid
CAGTTCAAATTGACAC-1	aneuploid
CAGTTCCGCGGGTCGA-1	aneuploid
CAGTTCGAGGACCCGA-1	diploid
CATAACGGACAGTCGT-1	diploid
CATAAGCTCTCCGTCT-1	aneuploid
CATAATGAGCGGGCGA-1	aneuploid
CATACAAAGCCGAACC-1	aneuploid
CATACACAAAGTCAGC-1	diploid
CATACCCGTACCCAGT-1	aneuploid
CATACGAACTAGCTGG-1	diploid
CATACGGCGTCTGGGC-1	diploid
CATACGGGTGCATGAT-1	aneuploid
CATACTATGTAATTGT-1	aneuploid
CATACTTAGGCAATAC-1	diploid
CATACTTCTTTCTCCG-1	diploid
CATAGAGGAGATACTA-1	diploid
CATAGCCGCCCGGGAT-1	aneuploid
CATAGCGTTGCCCACC-1	diploid
CATAGGGACACTTGTG-1	diploid
CATAGTACATTGAGAG-1	aneuploid
CATAGTAGCATAGTAG-1	aneuploid
CATAGTCAAATACATA-1	diploid
CATAGTCCACAAGAAC-1	aneuploid
CATATACTACTGATAA-1	aneuploid
CATATGTCAGGCTACG-1	aneuploid
CATATTATTTGCCCTA-1	diploid
CATCAAACTGGCGCCC-1	diploid
CATCAACACCTACTAA-1	aneuploid
CATCATCTACCCGGAC-1	aneuploid
CATCATTACCCTGAGG-1	diploid
CATCCAATATAGTTTG-1	diploid
CATCCCGAGATTCATA-1	diploid
CATCCGCAGGCCCGAA-1	aneuploid
CATCCTCTCAAAGATC-1	diploid
CATCGAATGGATCTCT-1	aneuploid
CATCGCCCGCGGCCAA-1	aneuploid
CATCGGACGGGTTAAT-1	diploid
CATCGTCCGGTTACTA-1	aneuploid
CATCTACCCGAGAACG-1	aneuploid
CATCTAGTGAAGGGAA-1	diploid
CATCTATCCCGTGTCT-1	aneuploid
CATCTGCAGGATCATT-1	aneuploid
CATCTTACACCACCTC-1	diploid
CATGAACCGACATTTG-1	aneuploid
CATGAACCTCTTATCA-1	diploid
CATGACTTCGCTGAAT-1	diploid
CATGAGATGCACTCTC-1	diploid
CATGAGTCCATCACGG-1	diploid
CATGATACGGTGAAAC-1	diploid
CATGATCGCTTTGAGA-1	diploid
CATGATGCACAATTCT-1	aneuploid
CATGATGGAAGTTAGC-1	diploid
CATGCACATGAGAGGC-1	diploid
CATGCACGTGTTACTG-1	aneuploid
CATGCATGGAGACCCT-1	aneuploid
CATGCCAACTCGCAAA-1	aneuploid
CATGCGACCAGTTTAA-1	diploid
CATGCGTTAGACAGAA-1	aneuploid
CATGCGTTGAGAGGAG-1	diploid
CATGCTGGCTCCAATT-1	aneuploid
CATGGAAATGGGACCA-1	aneuploid
CATGGATTGTCTTCCG-1	diploid
CATGGCAGGAAGATCG-1	aneuploid
CATGGCTCCCTATGTC-1	aneuploid
CATGGGTATGCCTTAT-1	diploid
CATGGGTCGGGTGTGG-1	aneuploid
CATGGTAAGTAGCGTT-1	diploid
CATGGTATTAGTTTGT-1	diploid
CATGGTCTAGATACCG-1	aneuploid
CATGGTTTATTAATCA-1	diploid
CATGTAAGAGACATTT-1	diploid
CATGTAGGAGCGCCAA-1	diploid
CATGTCTCATTTATGG-1	diploid
CATTACATAGATTGTG-1	diploid
CATTACGCAGGAAGGG-1	diploid
CATTACGTCGGCCCGT-1	aneuploid
CATTATAACAGGGTCC-1	aneuploid
CATTATGCTTGTTGTG-1	aneuploid
CATTCACTGACAGCTA-1	aneuploid
CATTCAGGTCAGTGCG-1	aneuploid
CATTCCCATTCCGTCG-1	diploid
CATTCCCTAAGTACAA-1	aneuploid
CATTCGTCGTAGCGGT-1	diploid
CATTGATGAACACGCC-1	diploid
CATTGCAAAGCATAAT-1	aneuploid
CATTGCGAAATGGGCG-1	aneuploid
CATTGCGGGTCAATTC-1	diploid
CATTGTGTGCTAGATC-1	aneuploid
CATTTAGCGGACCATG-1	diploid
CATTTATCGTTCAAGA-1	aneuploid
CATTTCTAGCAGACTA-1	aneuploid
CATTTGAGTGGTACGT-1	diploid
CCAAACAGAACCCTCG-1	aneuploid
CCAAAGCAGTTGGTTG-1	aneuploid
CCAAAGTCCCGCTAAC-1	aneuploid
CCAAATAACAAGATTC-1	diploid
CCAAATCAAAGGGCAA-1	diploid
CCAACCTTATGTAACT-1	diploid
CCAACGATGCACTGAT-1	aneuploid
CCAACGCTTGCCAGGG-1	aneuploid
CCAACTTGATAGATCC-1	diploid
CCAAGAAAGTGGGCGA-1	diploid
CCAAGACTTCTGCGAA-1	aneuploid
CCAAGCGTAACTCGTA-1	diploid
CCAAGCTTGATCTCCT-1	aneuploid
CCAAGGAACAGAGAGG-1	aneuploid
CCAAGGTTGCCCTTTC-1	diploid
CCAAGTTTCTACAGAT-1	aneuploid
CCAATAGATTTCATCT-1	aneuploid
CCAATAGTGCCGTCGA-1	aneuploid
CCAATCGGTAGATCGA-1	aneuploid
CCAATGTCACAGCAAG-1	aneuploid
CCAATTACGGGTCGAG-1	aneuploid
CCAATTGAATGTTAAT-1	aneuploid
CCACAATGTACGTCTT-1	diploid
CCACACTGAGATATTA-1	diploid
CCACAGCTGAAATCAT-1	aneuploid
CCACAGTACCCATCCT-1	diploid
CCACATACTGCACCCA-1	diploid
CCACATGGCTCTTTAT-1	diploid
CCACCCAAGGAAAGTG-1	diploid
CCACGAATTTAACCTC-1	diploid
CCACGAGAAGAGAATC-1	aneuploid
CCACGGAGCCATAAGA-1	aneuploid
CCACGGCAGGTGTAGG-1	diploid
CCACGGTGCCCGGTAG-1	diploid
CCACGTAAATTAGACT-1	diploid
CCACTAAACTGAATCG-1	aneuploid
CCACTATCCGGGTCAC-1	diploid
CCACTCAGATCCGCAA-1	diploid
CCACTGGTGGCTGGTT-1	aneuploid
CCACTGTTTGGATTAA-1	diploid
CCAGAAACTGATGCGA-1	diploid
CCAGAGACAAAGCCGG-1	aneuploid
CCAGATAGTTGAGTGA-1	diploid
CCAGATGTAAATGGGT-1	diploid
CCAGCCTGGACCAATA-1	diploid
CCAGCGGGATCACCAG-1	diploid
CCAGCTACGCCTCATA-1	aneuploid
CCAGCTCGAACGCATT-1	diploid
CCAGCTGATGGTACTT-1	aneuploid
CCAGCTTCCGCCCGCA-1	aneuploid
CCAGGCGAGATGGTCT-1	diploid
CCAGGCTGGCGTCTGA-1	diploid
CCAGGGACGTGGCCTC-1	aneuploid
CCAGTAGTCTGATCCA-1	diploid
CCAGTCAAATCTCTTA-1	aneuploid
CCAGTCCATTATTCGA-1	aneuploid
CCAGTCTAGACGGCGC-1	aneuploid
CCAGTGAGCTCCTTGT-1	aneuploid
CCAGTGTACAGACCGA-1	diploid
CCAGTTCGGTAACTCA-1	diploid
CCATAAACAACCCGAC-1	aneuploid
CCATAACCTGTGCAGT-1	diploid
CCATACCTTTACTTGT-1	diploid
CCATACTCGCCTCTCC-1	aneuploid
CCATAGAGGCTGCCAG-1	diploid
CCATAGGTTGGCGTGG-1	aneuploid
CCATAGTCAGTAACCC-1	aneuploid
CCATATGGAAACTATA-1	diploid
CCATATTGGATCATGA-1	aneuploid
CCATCATAAGAACAGG-1	aneuploid
CCATCCATACCAAGTC-1	aneuploid
CCATCGCAGTTAAACT-1	diploid
CCATCTCACCAGTGAA-1	diploid
CCATCTTGTTCACAAT-1	aneuploid
CCATGCCCTAGATTTC-1	diploid
CCATGCCTGTTTAGTA-1	aneuploid
CCATGCTCTGCAGGAA-1	aneuploid
CCATGGCAAACGCTCA-1	diploid
CCATGGCCCTTGTACC-1	aneuploid
CCATTAGCGATAATCC-1	aneuploid
CCATTCCCTGCCCACA-1	aneuploid
CCATTGTTTCCTCCAT-1	diploid
CCCAAACATGCTGCTC-1	diploid
CCCAACATACGTCGCG-1	aneuploid
CCCAACCACACTAACA-1	aneuploid
CCCAAGAATGCACGGT-1	diploid
CCCAAGACAGAGTATG-1	aneuploid
CCCAAGTCATTACACT-1	diploid
CCCAATGAGATTTGCA-1	diploid
CCCAATTTCACAACTT-1	aneuploid
CCCACTCCACGGTATC-1	diploid
CCCAGAGGAGGGCGTA-1	diploid
CCCAGGAAGAATTCGA-1	diploid
CCCAGGTCTGAAGGCT-1	diploid
CCCAGTAAACTTGGGA-1	diploid
CCCAGTTAAGGCGCCG-1	diploid
CCCATATAGGTCGATT-1	diploid
CCCATTATTGTATCCT-1	diploid
CCCGAAGTTTCGCGAA-1	aneuploid
CCCGACCATAGTCCGC-1	aneuploid
CCCGAGTTTCTCCGTA-1	diploid
CCCGCAGCGCGAACTA-1	diploid
CCCGCAGGGCCCAAAG-1	aneuploid
CCCGCCATGCTCCCGT-1	aneuploid
CCCGCGCAATGCACCC-1	aneuploid
CCCGCTAGAGGGTTAA-1	aneuploid
CCCGCTTGCCCTCGTC-1	aneuploid
CCCGGCACGTGTCAGG-1	diploid
CCCGGCTAGGTGAGAA-1	aneuploid
CCCGGGTCGTTCAGGG-1	diploid
CCCGGTGGAAGAACCT-1	aneuploid
CCCGGTGTATCGGAAT-1	diploid
CCCGTAAGTCTAGGCC-1	aneuploid
CCCGTAGCTGGGAAGA-1	diploid
CCCGTCAGCGTCTGAC-1	aneuploid
CCCGTGAGGGCGGTGA-1	aneuploid
CCCGTGGGTTAATTGA-1	aneuploid
CCCGTTTCGCAGATGT-1	diploid
CCCTACCCACACCCAG-1	diploid
CCCTACTTGAACAATG-1	diploid
CCCTAGGCAACAAGAG-1	aneuploid
CCCTAGTGTCAGGTGT-1	aneuploid
CCCTATGTAGAGCAGA-1	diploid
CCCTCAAGCTCTTAGT-1	aneuploid
CCCTCAGATCGAGAAC-1	diploid
CCCTCATTCTGGAATT-1	aneuploid
CCCTCCTCGCTCGTAT-1	diploid
CCCTCGATAATACACA-1	diploid
CCCTGAAATGAGTTGA-1	aneuploid
CCCTGACTAACAAATT-1	aneuploid
CCCTGATGTAACTCGT-1	diploid
CCCTGCCCAATCCGCT-1	aneuploid
CCCTGCGCTACGCATA-1	aneuploid
CCCTGGCTGTTCCTTC-1	aneuploid
CCCTGGGAGGGATCCT-1	diploid
CCCTGGTATGGGCGGC-1	aneuploid
CCCTGTTGGCAAAGAC-1	aneuploid
CCCTTCTCGTACGCGA-1	aneuploid
CCCTTTAATGGAGTTC-1	diploid
CCCTTTGACAGGTCTT-1	diploid
CCGAAACACGACCTCT-1	diploid
CCGAAAGTGGTGAGCA-1	aneuploid
CCGAACACTGGGCCTC-1	aneuploid
CCGAACCTTCCCGGCC-1	diploid
CCGAAGCATTGACCAA-1	diploid
CCGAAGGGCGTACCGC-1	diploid
CCGAAGTATATTGTTC-1	aneuploid
CCGACAAACACATGAG-1	aneuploid
CCGACAAAGGGAGTGC-1	aneuploid
CCGACAATAGGCCGCC-1	diploid
CCGACGGGCATGAGGT-1	diploid
CCGACGTAAACACAAC-1	aneuploid
CCGACTCGCATAGTCT-1	aneuploid
CCGAGAAGTCGCATAA-1	diploid
CCGAGCTGTGCTTGTC-1	diploid
CCGAGGGATGTTAGGC-1	aneuploid
CCGATCTCAACCTTAT-1	diploid
CCGATCTTAAGAGGCT-1	aneuploid
CCGATTCGAGGGACCC-1	aneuploid
CCGATTGGTCAATGAA-1	aneuploid
CCGCACACGAACGTGT-1	diploid
CCGCACGTGACCTCGG-1	aneuploid
CCGCACTTGCAATGAC-1	diploid
CCGCCACCACAATCCA-1	aneuploid
CCGCCGGAACTTCTCG-1	diploid
CCGCCGGTCAACACAC-1	aneuploid
CCGCCGTTGAGGATAA-1	diploid
CCGCCTGCGAATTGGT-1	aneuploid
CCGCCTTGCGATGTCG-1	aneuploid
CCGCGCAAGATACCCA-1	diploid
CCGCGGAATGCGTCAC-1	diploid
CCGCGGGTACGAAGAA-1	aneuploid
CCGCGTAGGTAAGGGC-1	aneuploid
CCGCTATCAGCACCAG-1	diploid
CCGCTCCAGGGCGATC-1	diploid
CCGCTCCGGATAAGCT-1	diploid
CCGCTCTTCCGAACTA-1	diploid
CCGCTGGTGCCATTCA-1	aneuploid
CCGCTTACCTCACTCT-1	aneuploid
CCGCTTCGCGGTTAAC-1	aneuploid
CCGCTTGCTGACATGG-1	diploid
CCGGAATGGTTTCAGT-1	aneuploid
CCGGAGGTCTTATGGT-1	diploid
CCGGCACGACCGTTTC-1	diploid
CCGGCCGCGAGCATAT-1	diploid
CCGGCGCATATTGGAT-1	aneuploid
CCGGCGTGAGACTCTG-1	diploid
CCGGGACCCGCAGAGA-1	aneuploid
CCGGGCTGCTCCATAC-1	diploid
CCGGGTTCGAGGTTAC-1	aneuploid
CCGGTAATGGCTAGTC-1	diploid
CCGGTGCGAGTGATAG-1	aneuploid
CCGGTTTGTAATTGTG-1	diploid
CCGTACCCAAGCGCCA-1	aneuploid
CCGTAGGAAATCCCTG-1	diploid
CCGTAGGGTTGTTTAC-1	diploid
CCGTATCTCGTCGTAG-1	diploid
CCGTATTAGCGCAGTT-1	diploid
CCGTCAACCTCTGGCG-1	diploid
CCGTGAGGCATTCATG-1	diploid
CCGTGCCCATGACGGC-1	aneuploid
CCGTGGAACGATCCAA-1	diploid
CCGTGTTAAATTCCAT-1	diploid
CCGTTACGTTAGAACA-1	aneuploid
CCGTTCCGAATCTCGG-1	aneuploid
CCTAAAGGCTGACGCT-1	aneuploid
CCTAAATTAACGGTTC-1	diploid
CCTAAATTGTATCCTA-1	diploid
CCTAACCCAAACAAGT-1	diploid
CCTAACTAAGGCTCTA-1	aneuploid
CCTAAGTGTCTAACCG-1	aneuploid
CCTACAAGTCCGGAAT-1	aneuploid
CCTACATTCACAGACG-1	diploid
CCTACGCGACCTTACA-1	aneuploid
CCTACGGCTCAGTCGA-1	aneuploid
CCTACTCAACACGATT-1	diploid
CCTACTGCGGCGGCCA-1	diploid
CCTACTGCTTACACTT-1	aneuploid
CCTAGGCGTAGCGATC-1	diploid
CCTAGGTAAAGGTAGC-1	diploid
CCTAGTTAGTCGCATG-1	aneuploid
CCTATAATGAGTGCCC-1	diploid
CCTATACCGTCCTGTC-1	diploid
CCTATATCGTGTCACG-1	diploid
CCTATCTATATCGGAA-1	aneuploid
CCTATGAAGTGGTGCC-1	diploid
CCTATGGCTCCTAGTG-1	diploid
CCTATGGGTTACCGTC-1	aneuploid
CCTATGGTCAAAGCTG-1	diploid
CCTATGTCCACTCCAC-1	diploid
CCTATTATTCCGGCCG-1	diploid
CCTCAACGATCGCTGT-1	diploid
CCTCACCAATCTTGAC-1	aneuploid
CCTCACCTGAGGGAGC-1	diploid
CCTCACCTTAGCATCG-1	diploid
CCTCACGTCAGCTAAT-1	diploid
CCTCATGCAGCTACGA-1	aneuploid
CCTCCCGACAATCCCT-1	aneuploid
CCTCCGACAATTCAAG-1	aneuploid
CCTCCTAGCTAGAGTC-1	diploid
CCTCCTGAGCCCACAT-1	aneuploid
CCTCCTGTTGTGTCGT-1	diploid
CCTCGAAGTGGACGGG-1	aneuploid
CCTCGACCCACTGCCT-1	aneuploid
CCTCGCCAGCAAATTA-1	aneuploid
CCTCGCGCGATATAGG-1	aneuploid
CCTCGGACCGGGATAG-1	diploid
CCTCGGATGCTACCTG-1	aneuploid
CCTCGGTTTCCTTGCC-1	diploid
CCTCGTTACGCCTGTT-1	aneuploid
CCTCTAATCTGCCAAG-1	aneuploid
CCTCTACAAGGATTGG-1	diploid
CCTCTATCGATTAGCA-1	diploid
CCTCTCTCCCATCTAG-1	aneuploid
CCTCTGGCCTAGACGG-1	aneuploid
CCTCTGTACTATTCTA-1	diploid
CCTGAACGATATATTC-1	diploid
CCTGAATATTTACATA-1	aneuploid
CCTGACAAACTCGCGC-1	aneuploid
CCTGACCACCGATGGT-1	diploid
CCTGACGCAACCTTTA-1	aneuploid
CCTGAGAATAAATGCA-1	diploid
CCTGCCCGTTGTCTAG-1	aneuploid
CCTGCGATAGAACTGT-1	aneuploid
CCTGCGTTCTACGCTT-1	aneuploid
CCTGCTATTTGAGAAG-1	aneuploid
CCTGGAAACGTTCTGC-1	diploid
CCTGGCTAGACCCGCC-1	aneuploid
CCTGGTCGAATGTGGG-1	diploid
CCTGTAAGACATGATA-1	aneuploid
CCTGTACTCACGCCCA-1	aneuploid
CCTGTCACCCGGGCTC-1	aneuploid
CCTGTCCCTCACGTTA-1	diploid
CCTGTCGCCCGTAAAT-1	diploid
CCTGTCGTGTATGAAG-1	diploid
CCTGTGAAACCGTAAC-1	aneuploid
CCTGTGCATAGGAGAC-1	aneuploid
CCTGTGCGGATTGTAA-1	aneuploid
CCTGTTCAACCTCGGG-1	diploid
CCTGTTTGAAGACACG-1	diploid
CCTTAAGTACGCAATT-1	diploid
CCTTCAGTTAAAGTGA-1	diploid
CCTTCGTATAGAATCC-1	diploid
CCTTCTCAGCGTTCCT-1	aneuploid
CCTTCTTGATCCAGTG-1	aneuploid
CCTTGACCACTTTATT-1	diploid
CCTTGTGAACGTGGTT-1	diploid
CCTTTAAGGGAGCACT-1	diploid
CCTTTCAATGAAGAAA-1	diploid
CCTTTGAATTATGGCT-1	diploid
CGAAACATAGATGGCA-1	aneuploid
CGAAACGCAATTCATG-1	aneuploid
CGAACAGTATGGGCGT-1	diploid
CGAACATAGTCAGAAA-1	aneuploid
CGAACCCGCATGCGTC-1	diploid
CGAACCTCTTTCCTAG-1	diploid
CGAACGCCCAGTGCCG-1	aneuploid
CGAACGGCCGGACAAC-1	diploid
CGAAGACGGTGAGTGC-1	aneuploid
CGAAGACTGCCCGGGA-1	aneuploid
CGAAGATCAGTTTCAT-1	diploid
CGAAGCCACAGCATGG-1	diploid
CGAAGCTATAAATTCA-1	diploid
CGAAGGGTTTCAGATT-1	diploid
CGAAGTTGCTCTGTGT-1	aneuploid
CGAATCTGCTCGACGC-1	diploid
CGAATGAAGTCATTGC-1	diploid
CGAATGACGCATAATG-1	diploid
CGAATGGTAGGTCGTC-1	diploid
CGAATTACATGGTGTT-1	aneuploid
CGACAATTTGATCTAA-1	diploid
CGACACCGCTTAAGGA-1	aneuploid
CGACACGCTCCGACAG-1	diploid
CGACACGGATGCCCAC-1	aneuploid
CGACAGTTCGCGTTAT-1	aneuploid
CGACATGCGATCTTCT-1	aneuploid
CGACCCTTAACGCCGG-1	diploid
CGACCGTTGGTATTCG-1	diploid
CGACCTACTAGACAAT-1	aneuploid
CGACGCATCCGTACCT-1	diploid
CGACTCAGGATGTTAT-1	aneuploid
CGACTCGGTACACGGT-1	aneuploid
CGACTTGCCGGGAAAT-1	diploid
CGACTTTGTATAGCCT-1	diploid
CGAGACCCTAGAGTGT-1	diploid
CGAGACTACTGCTGCT-1	diploid
CGAGAGATGTGAACCT-1	aneuploid
CGAGAGCGCGTAGATA-1	aneuploid
CGAGAGCTTTCACTAC-1	diploid
CGAGAGGGTAGCCGCG-1	diploid
CGAGATGTTGCCTATA-1	aneuploid
CGAGATTTCGCTCGGG-1	diploid
CGAGCACTTCAAGTTT-1	aneuploid
CGAGCCGAGCACTCGA-1	aneuploid
CGAGCGTTGATCAGCC-1	aneuploid
CGAGCTGGGCTTTAGG-1	aneuploid
CGAGGAGCTTCCATAT-1	diploid
CGAGGATCGGGAACGA-1	diploid
CGAGGCCAGGCATTGG-1	aneuploid
CGAGGCTAAATATGGC-1	aneuploid
CGAGGGACTGCGGTCG-1	diploid
CGAGGGTATCCAGGTG-1	diploid
CGAGTACTAAAGAGGA-1	aneuploid
CGAGTGAAGGTACCAG-1	diploid
CGAGTGCTATAGTTCG-1	aneuploid
CGAGTTCTGTCCCACC-1	diploid
CGAGTTTATCGGACTG-1	diploid
CGATAACCAATTTGAG-1	aneuploid
CGATAATACTCAGGTT-1	diploid
CGATACCTCGCGGACA-1	diploid
CGATAGCGATACAGTG-1	diploid
CGATAGTCGTACTGCA-1	diploid
CGATATTAGCCGCAGG-1	aneuploid
CGATCATTAGAGGCAC-1	aneuploid
CGATCCACCATTGTTG-1	diploid
CGATCCGACCCAGTGC-1	diploid
CGATCCTCGCAACATA-1	diploid
CGATCGAGAAGCACCA-1	diploid
CGATCTGTTGGAGGAC-1	aneuploid
CGATGGACCCTACGCC-1	aneuploid
CGATGTTGTTATCTAC-1	diploid
CGATTTGTCATTAATG-1	diploid
CGCAAACACGAGTTAC-1	aneuploid
CGCAATCGATCATTAG-1	aneuploid
CGCAATTACTTTCGGT-1	aneuploid
CGCAATTAGGGTAATA-1	aneuploid
CGCAATTCTACAATAA-1	aneuploid
CGCACATGTCCACTAC-1	diploid
CGCACGTCTGTTTATG-1	diploid
CGCACGTGCGCTATCA-1	diploid
CGCAGAAACATTTGCG-1	aneuploid
CGCAGATCTTCACCCG-1	diploid
CGCAGGCGATCCAAAC-1	diploid
CGCATCATGGCTTCAG-1	aneuploid
CGCATCCATCAGCCAG-1	diploid
CGCATGCCGAATGCGT-1	diploid
CGCATGGTGCGATGCT-1	diploid
CGCATTAGCTAATAGG-1	aneuploid
CGCCAAGAAGCCGAGT-1	aneuploid
CGCCAATTATTGCGTT-1	aneuploid
CGCCACAGGTCGCGAT-1	diploid
CGCCACCCGCATTAAC-1	aneuploid
CGCCATCCGATTATGA-1	aneuploid
CGCCCAGCACGCCTAG-1	diploid
CGCCCAGCGTTTCACG-1	diploid
CGCCCGCTTCCGTACA-1	aneuploid
CGCCCTAATTGTTCAA-1	diploid
CGCCCTTACATCCACC-1	aneuploid
CGCCCTTGAAGGCTGA-1	aneuploid
CGCCGACTATTCGCTA-1	aneuploid
CGCCGCCCATGCCTGT-1	diploid
CGCCGCGTTCTGAACG-1	diploid
CGCCGGTGTCGCAGTA-1	diploid
CGCCGTCTACCCATCG-1	diploid
CGCCGTTCAGCATAGT-1	diploid
CGCCTCCCTCCTCTAT-1	diploid
CGCCTGGCCTACGTAA-1	aneuploid
CGCCTTTAGCATGCTC-1	diploid
CGCGAAGTGGCATACT-1	diploid
CGCGACACTGCGCAGC-1	aneuploid
CGCGACCGCGACAGAT-1	diploid
CGCGAGAGGGACTTGT-1	diploid
CGCGAGTCTGCCGGGT-1	diploid
CGCGCAAATGTCCAGA-1	diploid
CGCGCAAGGAACTACA-1	aneuploid
CGCGCATGTTTGATTG-1	diploid
CGCGCCCGACTTAATA-1	aneuploid
CGCGGCAGTATTACGG-1	diploid
CGCGGCTCAACTTGAA-1	diploid
CGCGGGAATTAGGCAG-1	diploid
CGCGGGAATTCCTTTC-1	diploid
CGCGGTAAGTCTAGCT-1	diploid
CGCGGTACGGTATACA-1	diploid
CGCGGTCACAAACCAA-1	diploid
CGCGTACATTCTGGAA-1	aneuploid
CGCGTCATATTAAACC-1	aneuploid
CGCGTGCTATCAACGA-1	aneuploid
CGCGTGGGCCTGTGTT-1	diploid
CGCGTTCATGAAATAC-1	aneuploid
CGCTACCGCCCTATGA-1	aneuploid
CGCTACGGGACATTTA-1	diploid
CGCTAGAGACCGCTGC-1	diploid
CGCTATACCGCCCACT-1	aneuploid
CGCTATCGTGGCTTTA-1	aneuploid
CGCTATTCAATGTATG-1	aneuploid
CGCTATTCTTAGGCTC-1	diploid
CGCTCGACATAATGAT-1	aneuploid
CGCTCTCCGTAGATTA-1	aneuploid
CGCTGAGGACGTCCAA-1	aneuploid
CGCTGGTGACTACCCT-1	diploid
CGCTGTGACGCCGCAC-1	aneuploid
CGCTGTGTGGATGTTG-1	diploid
CGCTTAGTATTGATAC-1	diploid
CGCTTATTCCCGGTCG-1	aneuploid
CGCTTCCACTGAAATC-1	aneuploid
CGCTTCGGTCTAAGAC-1	diploid
CGCTTGGACGGATAGA-1	diploid
CGCTTTCATACCGGTG-1	aneuploid
CGCTTTCCGCCAAGGT-1	diploid
CGCTTTCTTGCATTCG-1	diploid
CGGAAAGAATCAAACG-1	diploid
CGGAAAGCAAATGTGC-1	aneuploid
CGGAAATTTCACATCC-1	aneuploid
CGGAACGTAAACATAG-1	diploid
CGGACCTTTACGTCCC-1	diploid
CGGACGTTACTTGAAG-1	aneuploid
CGGAGCAATTTAATCG-1	diploid
CGGAGCATGGCGATCC-1	diploid
CGGAGCTTATAACACC-1	aneuploid
CGGAGTCCTAACCTGG-1	aneuploid
CGGAGTTTGAGAGACA-1	aneuploid
CGGATAAGCGGACATG-1	aneuploid
CGGATCCTCAAGGACT-1	diploid
CGGCAAACATCGTGCG-1	diploid
CGGCAATAAGATCGCC-1	diploid
CGGCACTCAAGAAAGT-1	aneuploid
CGGCAGGGTCGGGTTG-1	diploid
CGGCCACGCACAAAGT-1	aneuploid
CGGCCAGAGCGACCAT-1	diploid
CGGCCCAACCTGTAGT-1	diploid
CGGCCCAGGTATATCC-1	diploid
CGGCGCCATCAATCCC-1	diploid
CGGCTCTAAAGCTGCA-1	diploid
CGGCTCTTCGTCGAAC-1	aneuploid
CGGCTGAAGGTTACGC-1	aneuploid
CGGCTGCAAGATTAAG-1	aneuploid
CGGCTTTGTATGATAA-1	aneuploid
CGGGAACGCCCTGCAT-1	diploid
CGGGAAGTACCGTGGC-1	diploid
CGGGAATATAGTATAC-1	diploid
CGGGAATTTATGTAAA-1	diploid
CGGGAGCTTCAGTGTA-1	diploid
CGGGAGTATACCGCCG-1	aneuploid
CGGGATCAATGTAAGA-1	aneuploid
CGGGCAGCTAAACCGC-1	aneuploid
CGGGCCATAGCCGCAC-1	aneuploid
CGGGCCTTCTTTGTAA-1	diploid
CGGGCGATGGATCACG-1	diploid
CGGGCTACTTAAATTG-1	aneuploid
CGGGTGTACCCATTTA-1	diploid
CGGGTTCGGCACGTAT-1	aneuploid
CGGGTTGTAGCTTTGG-1	aneuploid
CGGGTTTGTTAGGGCT-1	diploid
CGGTAACAAGATACAT-1	aneuploid
CGGTACGGCAAACCCA-1	diploid
CGGTACTAGAATCAAA-1	diploid
CGGTAGAGGTGCAGGT-1	aneuploid
CGGTATAGGTATTAGC-1	aneuploid
CGGTATGGGCACTCTG-1	diploid
CGGTCAAGTGGGAACC-1	diploid
CGGTCCATGAGACTCC-1	diploid
CGGTCCGTCGCAAGCC-1	diploid
CGGTCTATCAACCCGT-1	aneuploid
CGGTGAAGACTAAAGT-1	aneuploid
CGGTGCAGATAGAACG-1	aneuploid
CGGTGCGCGTTGGTCC-1	diploid
CGGTGGGCTCCAGCCT-1	aneuploid
CGGTGTACTTGATCCC-1	aneuploid
CGGTTATCCAACAGTG-1	diploid
CGGTTCAAGTAGGTGT-1	diploid
CGGTTCCGGCTTCTTG-1	aneuploid
CGGTTGACCTGGCATA-1	aneuploid
CGGTTGAGTATCCTTC-1	diploid
CGGTTGGGCAGGGTCC-1	diploid
CGGTTGGGTTCAAGTT-1	aneuploid
CGGTTTACTGAACATT-1	diploid
CGGTTTATGAAGGAAC-1	aneuploid
CGTAAACGCTTGAGTG-1	aneuploid
CGTAAAGCAAGAAATC-1	diploid
CGTAAATAACAAAGGG-1	diploid
CGTAACGGAACGATCA-1	aneuploid
CGTAACTTCGACACTT-1	diploid
CGTAATAATTACGAGT-1	aneuploid
CGTACCGAAAGTCTAG-1	aneuploid
CGTACCTGATAGGCCT-1	aneuploid
CGTAGAGAGTAATTAT-1	diploid
CGTAGCGAATTGTCAG-1	aneuploid
CGTAGCGCCGACGTTG-1	aneuploid
CGTATCTAGAACTAAG-1	diploid
CGTATTAAGAGATCTA-1	aneuploid
CGTATTGTTTCCTAAT-1	diploid
CGTATTGTTTGGCGCC-1	diploid
CGTCAAATGGTCGCAG-1	diploid
CGTCAAGGCTATAAAT-1	aneuploid
CGTCAATCTTTAACAT-1	aneuploid
CGTCACGTCCATTGGT-1	diploid
CGTCAGCTATTTACTC-1	aneuploid
CGTCAGTGCGCACAAG-1	aneuploid
CGTCAGTTTATCGTCT-1	aneuploid
CGTCATACCATATCCA-1	aneuploid
CGTCCAGATGGCTCCA-1	aneuploid
CGTCCTCATCGCGTGC-1	diploid
CGTCGCATGTGAGCCA-1	diploid
CGTCGCGGCGGGATTT-1	aneuploid
CGTCGCTTGGTTATAC-1	diploid
CGTCGGATAGTGTTGA-1	diploid
CGTCGGGTCTAAGCGC-1	diploid
CGTCGTCCTTCGCGAA-1	diploid
CGTCTCTCGCCGAGGC-1	diploid
CGTCTGGAAGGGCCCG-1	aneuploid
CGTCTTGAGTGTGACG-1	diploid
CGTGAACTGACCCGAT-1	diploid
CGTGAAGTTAATTCAC-1	diploid
CGTGACATTGGGTCGT-1	aneuploid
CGTGACCAGTCCTCTG-1	diploid
CGTGCACACCACTGTA-1	diploid
CGTGCAGACTGGGACA-1	diploid
CGTGCATTGTCGACGC-1	aneuploid
CGTGCCCGACATTTGT-1	aneuploid
CGTGCCCTCCCGAAGA-1	diploid
CGTGCTGGCCTAGTCG-1	aneuploid
CGTGCTTCTACCTAAA-1	diploid
CGTGGAAGCCTCGTAC-1	diploid
CGTGGCCGAATATCTA-1	diploid
CGTGGTACCCAAAGGC-1	diploid
CGTGTATGGGAGCTGA-1	diploid
CGTGTCCCATTCGCGA-1	aneuploid
CGTGTCTCGTTACGAC-1	diploid
CGTGTGTTAAACCCTG-1	diploid
CGTTAATGTCCCGACG-1	diploid
CGTTAGCTCACAACTG-1	aneuploid
CGTTATCATACTTCCA-1	aneuploid
CGTTCAAGGAAACGGA-1	diploid
CGTTCAGACCCGCGAA-1	diploid
CGTTCATGGTGCGCGT-1	aneuploid
CGTTCTTCGCACACCT-1	diploid
CGTTGAATACCGCGCT-1	diploid
CGTTGAGCGACCGTCG-1	diploid
CGTTGAGTAATTGCGT-1	aneuploid
CGTTGCCCGCGTGGGA-1	diploid
CGTTGTAAACGTCAGG-1	aneuploid
CGTTGTAAGATTGATT-1	diploid
CGTTGTCGGCAATTGA-1	diploid
CGTTGTTTCAATTCCC-1	aneuploid
CGTTTAAGCGGAGCAC-1	aneuploid
CGTTTACAAGGCAGCT-1	diploid
CGTTTCACTTCGGGCG-1	aneuploid
CGTTTCGCTCATTACA-1	aneuploid
CGTTTGGTGTTGTGGG-1	diploid
CGTTTGTGTAGAGGGT-1	diploid
CTAAACGGGTGTAATC-1	aneuploid
CTAAAGAATGCCTACT-1	aneuploid
CTAAAGGGAAATAGGA-1	diploid
CTAAAGTCCGAAGCTA-1	aneuploid
CTAAATCCGGTGTACA-1	diploid
CTAAATCCTATTCCGG-1	aneuploid
CTAACAGCACAATAAC-1	diploid
CTAACCGCGCGCCCGT-1	aneuploid
CTAACGAAACTTGCTG-1	diploid
CTAACTGATAATCGCC-1	diploid
CTAACTGGTCCGGTTC-1	diploid
CTAAGGGAATGATTGG-1	diploid
CTAAGTACAGGGCTAC-1	aneuploid
CTAATGCGCCCAACAA-1	aneuploid
CTAATTATGAAGCGTA-1	aneuploid
CTAATTCGCACGCGCT-1	aneuploid
CTAATTCTCAGATATT-1	diploid
CTAATTTCAACAACAC-1	aneuploid
CTACAAGAAATAACCC-1	diploid
CTACACTAGCTTGTTC-1	aneuploid
CTACACTCGCAGATGG-1	diploid
CTACATATCGCGGGAC-1	diploid
CTACCCTAAGGTCATA-1	diploid
CTACGAACTAGGTCGA-1	aneuploid
CTACGACTAGCTATAA-1	aneuploid
CTACGATCCTATCCTA-1	diploid
CTACGCACGGAGTACC-1	aneuploid
CTACGCCATTTCCGAT-1	aneuploid
CTACGTGTTGCCACCA-1	aneuploid
CTACTATCATAGGTTT-1	diploid
CTACTATCTTTCAGAG-1	diploid
CTACTCAAGGTATAGT-1	diploid
CTACTCTAGGCCCGGC-1	aneuploid
CTACTGCCACCTGACC-1	aneuploid
CTAGACATATATGTAG-1	aneuploid
CTAGACTGCATTTCGT-1	aneuploid
CTAGATAAACTCCTCG-1	aneuploid
CTAGATGTGAGTGTAA-1	diploid
CTAGATTTACGACGGC-1	diploid
CTAGCAACTAATTTAC-1	aneuploid
CTAGCATAGTATAATG-1	diploid
CTAGCCACAGGCGAGC-1	diploid
CTAGCCGATGTTATGA-1	diploid
CTAGCGCCAATCCTAC-1	aneuploid
CTAGGCGCCCTATCAG-1	diploid
CTAGGCGGCAGAGAAT-1	aneuploid
CTAGGGATAGGGACAA-1	diploid
CTAGGTCTGAAGGAAT-1	diploid
CTAGGTTCGGACGTGA-1	diploid
CTAGTAGAAAGGGATT-1	diploid
CTAGTATTCGGAATTA-1	aneuploid
CTAGTCACGTCTTAAG-1	diploid
CTAGTGAAGGACAGGA-1	aneuploid
CTAGTTACAACCCGGT-1	diploid
CTAGTTGGGCCCGGTA-1	aneuploid
CTATAAGAGCCAATCG-1	diploid
CTATACTTAAAGCGAG-1	diploid
CTATAGGCGTTGATGT-1	diploid
CTATATCCAGCCTGGC-1	diploid
CTATCACAACGCTGGA-1	diploid
CTATCGACGAAATACA-1	diploid
CTATCGCGTAGAGAAC-1	diploid
CTATGAACACCTTGCC-1	diploid
CTATGCCCGAATGCAA-1	diploid
CTATGGGAAGCGGAAT-1	diploid
CTATGTCACTAGCCCA-1	aneuploid
CTATGTCTATTGAAAC-1	aneuploid
CTATGTGAGTCACGGC-1	aneuploid
CTATTCATGTGTCCCA-1	diploid
CTATTGTGTTTGGTCA-1	aneuploid
CTATTTGCTTGGAGGA-1	diploid
CTCAACTAACCCGGAT-1	diploid
CTCAAGACATTAGCGC-1	aneuploid
CTCACACGCAAGCCTA-1	diploid
CTCACATTTACTAAAT-1	diploid
CTCACCAGTACAAGTG-1	aneuploid
CTCACCGATCCAAACT-1	aneuploid
CTCACTGTGATACTTA-1	diploid
CTCACTTGGCTGGTAA-1	aneuploid
CTCAGAGCTAATGTCG-1	diploid
CTCAGATTGTGATAAG-1	aneuploid
CTCAGCAGACTGCCGA-1	aneuploid
CTCAGGACTCACCTGT-1	aneuploid
CTCAGTCACGACAAAT-1	diploid
CTCATAAATGTGTATA-1	diploid
CTCATCACTTAGTGAT-1	diploid
CTCATGGCTCACAATC-1	aneuploid
CTCATGGTAATTTGCG-1	diploid
CTCATTAACGTTGCCC-1	diploid
CTCATTCGTGAACATC-1	aneuploid
CTCATTGCTCTAACAA-1	diploid
CTCATTTGATGGGCGG-1	aneuploid
CTCCCAATGAGTCGCG-1	diploid
CTCCCTCCTTTCGATC-1	diploid
CTCCCTTGTATCAAGG-1	diploid
CTCCGAGTAAATCCGC-1	aneuploid
CTCCGCCCACATGAGG-1	aneuploid
CTCCGGCCTAATATGC-1	aneuploid
CTCCGGCTTGTAGACA-1	aneuploid
CTCCTAAGTTATGTCT-1	aneuploid
CTCCTAGTAATCGTGA-1	diploid
CTCCTGTTCAAGGCAG-1	diploid
CTCCTTTACGCAAGTC-1	diploid
CTCGAATGGAACGTAT-1	aneuploid
CTCGAGACATACGATA-1	diploid
CTCGAGATCCAAAGCA-1	aneuploid
CTCGAGGCAAGTTTCA-1	diploid
CTCGAGGTCGAACAGT-1	aneuploid
CTCGATATTTGCGAGC-1	diploid
CTCGCACCTATATAGT-1	aneuploid
CTCGCATTGCATAGCC-1	diploid
CTCGCCGAATGTAGGG-1	diploid
CTCGCTAGGTAAGCGA-1	diploid
CTCGGGATAACACCTA-1	diploid
CTCGGGCATCGTCGGG-1	aneuploid
CTCGGGTTCTCTGGCC-1	diploid
CTCGGTACCACTGCTC-1	diploid
CTCGGTCCGTAGCCTG-1	aneuploid
CTCGGTTGTCGGCCCT-1	diploid
CTCGTCGAGGGCTCAT-1	diploid
CTCGTCTGTGCCTTCG-1	diploid
CTCGTGGCACTGAAAG-1	diploid
CTCGTTACGGCTACCA-1	diploid
CTCGTTTCTAATGTTT-1	diploid
CTCTAATGCATTGATC-1	diploid
CTCTACACTGGCGATT-1	aneuploid
CTCTACATCCTGCGTG-1	diploid
CTCTAGCCCTCGGAAA-1	diploid
CTCTATTTGGCTGCAG-1	diploid
CTCTCACAATCGATGA-1	aneuploid
CTCTCGATGTGCGCCT-1	diploid
CTCTCGCTGTACTATG-1	aneuploid
CTCTCTAACTGCCTAG-1	diploid
CTCTGCAGGCATTCTT-1	diploid
CTCTGCGAAGCAAGCA-1	aneuploid
CTCTGGACGCCTGGTG-1	aneuploid
CTCTGTCCATGCACCA-1	diploid
CTCTGTGCCTGCTATG-1	aneuploid
CTCTGTTTGAGGATTC-1	aneuploid
CTCTTCTATTGACTGG-1	diploid
CTCTTCTGGAAGTTAG-1	diploid
CTCTTGTCCCGCTTGG-1	diploid
CTGAAACGGCCCTCAG-1	aneuploid
CTGAAAGAGATCCGAC-1	aneuploid
CTGAATCCGAGACCTC-1	diploid
CTGAATTTATTGCCAG-1	diploid
CTGACATAGAAATAGA-1	diploid
CTGACTGCGCAGCTCG-1	aneuploid
CTGAGAAAGTTCGGCG-1	diploid
CTGAGCAAGTAACAAG-1	aneuploid
CTGAGCGAGACTTATT-1	diploid
CTGATAGTGTATCTCA-1	aneuploid
CTGATCCCTTTATGCA-1	diploid
CTGCAAATGGGCTCCA-1	aneuploid
CTGCAAGCACGTTCCG-1	diploid
CTGCACAACTACATAT-1	diploid
CTGCACCTAGTCCACA-1	diploid
CTGCACCTGGAACCGC-1	aneuploid
CTGCAGAGAATCAGAG-1	diploid
CTGCAGGTGCTCGGCC-1	aneuploid
CTGCCAAGGTTGGAAG-1	aneuploid
CTGCCATGCATCACAT-1	diploid
CTGCCCACGAAGCGTT-1	aneuploid
CTGCCTAGCCACCAAG-1	aneuploid
CTGCCTCATATGCAAC-1	diploid
CTGCCTTTAATACCTT-1	diploid
CTGCCTTTCTAGTAAA-1	diploid
CTGCGACCTCGCCGAA-1	diploid
CTGCGATTTCGAGATT-1	diploid
CTGCGGGTGAAATGTT-1	aneuploid
CTGCGGTAGTCACGTG-1	aneuploid
CTGCGTTACGATATAA-1	aneuploid
CTGCTCTCAACACACC-1	diploid
CTGCTCTGACGGCAAA-1	diploid
CTGCTGAGGCCACGAA-1	diploid
CTGCTGTCTAACGAGC-1	diploid
CTGCTTTATGTCCGCG-1	diploid
CTGGAAATGGATGCTT-1	aneuploid
CTGGAAGACACGGTGG-1	diploid
CTGGACGCAGTCCGGC-1	diploid
CTGGATTTACACTTGA-1	diploid
CTGGCATCCGAATGAG-1	aneuploid
CTGGCGACATAAGTCC-1	aneuploid
CTGGCGATTTACATGT-1	diploid
CTGGCGCACAGGTCTG-1	diploid
CTGGCGGGAATAAGTA-1	aneuploid
CTGGCTCCTGCGGGAT-1	aneuploid
CTGGCTGATTCATCCT-1	diploid
CTGGCTGCTAACGTAA-1	diploid
CTGGCTGGTTGTCAGT-1	diploid
CTGGGATAAATAATGG-1	diploid
CTGGGATACGCTACCC-1	diploid
CTGGGATCGCCCAGAT-1	aneuploid
CTGGGCACTAGTCGGA-1	aneuploid
CTGGGCCTGCTATATC-1	aneuploid
CTGGGCGGCCAAATGT-1	aneuploid
CTGGGCTATCCTTTGG-1	aneuploid
CTGGGTAGGCAGTTAA-1	diploid
CTGGGTTGAGTTAAAG-1	diploid
CTGGTAAAGACTTACA-1	diploid
CTGGTAAAGTGTGGGC-1	diploid
CTGGTAACACATAGAA-1	diploid
CTGGTAACGAGCTCTT-1	diploid
CTGGTCATTCCAATCC-1	aneuploid
CTGGTCCTAACTTGGC-1	aneuploid
CTGGTGAATGGGCCTA-1	diploid
CTGGTTCAACGCATCA-1	aneuploid
CTGGTTCGCGAGCTAC-1	diploid
CTGGTTTCGAGCAAGA-1	diploid
CTGTACTTCTTAGCAT-1	diploid
CTGTAGCCATCTCACT-1	diploid
CTGTAGTGAGGATCGA-1	diploid
CTGTATGGTGTAGAAA-1	aneuploid
CTGTCAAATGGCTCGG-1	aneuploid
CTGTCACGCCAGGCGC-1	aneuploid
CTGTCCTGCGCACTAC-1	diploid
CTGTCTGTGGCTGGCT-1	aneuploid
CTGTGCAGGGTAGGTC-1	diploid
CTGTGGTCGGGAGATA-1	diploid
CTGTTACCCAATCTAG-1	diploid
CTGTTCACTGCCTGTG-1	aneuploid
CTGTTCATCTCACGGG-1	aneuploid
CTGTTGGCTCTTCTGA-1	aneuploid
CTGTTGTTCAGTCGTA-1	diploid
CTTAAATAAGACCCAT-1	aneuploid
CTTAACTTACAGTATA-1	diploid
CTTAACTTCGAAGTAC-1	aneuploid
CTTAAGCAGCGAGCCG-1	diploid
CTTAATCGACTTAGTA-1	diploid
CTTACACGGTATTCCA-1	aneuploid
CTTACACTGGGAAATA-1	aneuploid
CTTACATAGATTTCTT-1	diploid
CTTAGATGTTTCATCC-1	diploid
CTTAGCCCGGATAGTG-1	aneuploid
CTTAGCCTTCCACATG-1	aneuploid
CTTAGGTATAGACCAG-1	diploid
CTTAGGTCCCAATCGT-1	diploid
CTTAGTAGGCCTACAG-1	diploid
CTTAGTGTAGTAGCAT-1	diploid
CTTATAGATGGCTGTT-1	diploid
CTTATGCGCTCAGGGC-1	aneuploid
CTTATGTTGACTACCA-1	aneuploid
CTTCAACTCCACTTGG-1	diploid
CTTCAGTGGTCGCCTA-1	diploid
CTTCAGTTGGACAACG-1	diploid
CTTCATAGCTCAAGAA-1	aneuploid
CTTCATTGTCAGTGGA-1	diploid
CTTCCGCTCCGTGAAG-1	diploid
CTTCCTGCATATTTAC-1	aneuploid
CTTCGATTGCGCAAGC-1	diploid
CTTCGGCCAATTGTTT-1	diploid
CTTCGTAGATAGGTGA-1	diploid
CTTCTATGTTGAAGTA-1	aneuploid
CTTCTATTAATGCTAG-1	diploid
CTTCTTACGTCGTATA-1	aneuploid
CTTGACCCGAAAGATA-1	aneuploid
CTTGAGGTTATCCCGA-1	aneuploid
CTTGAGTTAGGGTAAT-1	diploid
CTTGATGACCATCCAG-1	diploid
CTTGCAACCGCCTCCT-1	aneuploid
CTTGCCCACCCACGCA-1	diploid
CTTGCCCAGGCTCTAC-1	diploid
CTTGGCCAAGCTGGGA-1	diploid
CTTGTACTTGTTGACT-1	aneuploid
CTTGTCAACATTCGAG-1	diploid
CTTGTCGTACGTGTCA-1	aneuploid
CTTGTGAGGACAGCGG-1	aneuploid
CTTGTGAGTCTTTGAC-1	aneuploid
CTTGTGCTCACCGATT-1	aneuploid
CTTGTTGCTGAGTCAA-1	diploid
CTTGTTTATGTAGCCA-1	aneuploid
CTTTAACTTTCAAAGG-1	aneuploid
CTTTAATATTGGTCGA-1	diploid
CTTTACCGAATAGTAG-1	diploid
CTTTAGGAACACTGTT-1	diploid
CTTTAGTGCTATTATT-1	diploid
CTTTCTGTGCGGGCTT-1	diploid
CTTTGAAACATATTCC-1	aneuploid
CTTTGACGTCGCTTCT-1	aneuploid
CTTTGCATCGCTCTTG-1	diploid
CTTTGCTGTCATGGAT-1	diploid
CTTTGGCAGACAGAGT-1	aneuploid
CTTTGGCGCTTTATAC-1	aneuploid
CTTTGGCTTTAGTAAA-1	aneuploid
CTTTGGGATTGTTGCA-1	diploid
CTTTGTCGAATGCTCC-1	diploid
GAAACAGATGACCACC-1	diploid
GAAACAGCCATGCAGT-1	aneuploid
GAAACATAGGAAACAG-1	diploid
GAAACCATGGTGCGCT-1	diploid
GAAACCTATACAAATG-1	diploid
GAAACTCGTGCGATGC-1	aneuploid
GAAACTCTAATGAAGG-1	aneuploid
GAAAGAACAGCGTTAT-1	diploid
GAAAGCAGTGCACTTT-1	diploid
GAAAGCCCTTTGGACC-1	aneuploid
GAAAGTGACTAACTGC-1	aneuploid
GAAATACCTGCTGGCT-1	aneuploid
GAAATACTAAACGTTT-1	aneuploid
GAAATATCACCATCAG-1	aneuploid
GAAATATGCTTGAATG-1	diploid
GAAATCGCGCGCAACT-1	aneuploid
GAAATCTGACCAAGTT-1	aneuploid
GAAATGGCGGTGTTAG-1	aneuploid
GAAATGGGATGTAAAC-1	aneuploid
GAAATTAGCACGGATA-1	aneuploid
GAAATTCACATCGCTG-1	aneuploid
GAACAACTGGGATGAA-1	diploid
GAACACACATCAACCA-1	aneuploid
GAACAGATTACTAAAT-1	diploid
GAACATTAGTATGTTA-1	diploid
GAACCATCTGGGAGAC-1	aneuploid
GAACCCTCTGTGTTCT-1	diploid
GAACCTCGACCTACAC-1	aneuploid
GAACCTTTAACGATCC-1	diploid
GAACGACCGAATGATA-1	aneuploid
GAACGATAAGTTAAAG-1	diploid
GAACGCGGGTCACACG-1	diploid
GAACGGTGTAAAGCAG-1	aneuploid
GAACGTCTCATGGTCG-1	diploid
GAACGTTAGGAAGACG-1	aneuploid
GAACTGTGGAGAGACA-1	diploid
GAACTTAGCGCCCGGT-1	aneuploid
GAACTTGTGCACGGGA-1	diploid
GAAGAAACGATATTGT-1	diploid
GAAGAACGGTGCAGGT-1	aneuploid
GAAGACTTCAATGCCG-1	aneuploid
GAAGCAAGGCAATGTT-1	diploid
GAAGCCACTGATTATG-1	diploid
GAAGCCGGGTAAGCTC-1	aneuploid
GAAGCCTGCACATTCC-1	diploid
GAAGCGTGAGGAATTT-1	aneuploid
GAAGCTCGGACCCGTC-1	diploid
GAAGCTCTTTGCTTAG-1	aneuploid
GAAGCTTGCTGACCGC-1	aneuploid
GAAGGACTAAATTGAA-1	aneuploid
GAAGGAGTCGAGTGCG-1	diploid
GAAGGCTACCATTGTT-1	diploid
GAAGGGCATAACCATG-1	aneuploid
GAAGGGTCATTAAGAC-1	diploid
GAAGTCAGTTGCACTA-1	diploid
GAAGTCTCCCTAGCGA-1	diploid
GAAGTGATTTATCGTG-1	diploid
GAAGTGCTGGATAGCT-1	aneuploid
GAAGTTTCCACTCAAT-1	aneuploid
GAATAGACGCGACCCA-1	diploid
GAATAGCATTTAGGGT-1	diploid
GAATAGCCCTGCGGTC-1	diploid
GAATAGTGCTCGATTA-1	diploid
GAATATTCGGAGTCCC-1	aneuploid
GAATCGACATGGTCAC-1	aneuploid
GAATCGCCGGACACGG-1	aneuploid
GAATCTATACTCGGAC-1	aneuploid
GAATCTGAACATTCTC-1	diploid
GAATGAAGGTCTTCAG-1	diploid
GAATGCCGAAATGACC-1	aneuploid
GAATGCGAATCGGTTC-1	diploid
GAATGGGCTTATCGAC-1	aneuploid
GAATGTATGGCAGGTC-1	aneuploid
GAATGTGGTCCGGATT-1	diploid
GAATGTTGGGTAATCT-1	aneuploid
GAATTATAGTGAAAGG-1	diploid
GAATTATGCAACCTAC-1	aneuploid
GAATTCACCCGGGTGT-1	diploid
GAATTTCTCGCTGCAG-1	aneuploid
GACAAACATATGCAGG-1	diploid
GACAACGACCATTGAA-1	aneuploid
GACAACGCAGCTTACG-1	aneuploid
GACAAGACGCCCGTGC-1	diploid
GACAAGAGATGAGATT-1	diploid
GACACAAGGGAAGAAA-1	diploid
GACACAGCCGGGACTG-1	diploid
GACACCCAAAGACGCG-1	diploid
GACACGAGTTAGAGGA-1	aneuploid
GACACTGAGTTCAGTG-1	diploid
GACACTGGAACCCGAT-1	diploid
GACACTTCCAATTACC-1	diploid
GACAGATTTCTGGCTC-1	aneuploid
GACAGCCAGACCTGAC-1	diploid
GACAGGCACACACTAT-1	aneuploid
GACATACTGTCGCAGA-1	aneuploid
GACATCCGTCGAACTG-1	diploid
GACATCGATTTATAAC-1	diploid
GACCAAACGTTGACTG-1	diploid
GACCACACTTCCCTTT-1	diploid
GACCAGAGCCCTGTAG-1	aneuploid
GACCAGGTCATTCATA-1	aneuploid
GACCCAATTATGATAC-1	diploid
GACCCGTCGCCGGCTA-1	aneuploid
GACCGACCGCTAATAT-1	aneuploid
GACCGACGTGAAAGCA-1	diploid
GACCGACTGAAGCGTC-1	aneuploid
GACCGATTAAATATGT-1	diploid
GACCGCGTCTGACGTG-1	diploid
GACCGGTGATACTCTC-1	diploid
GACCGTCAGGTCGTGA-1	aneuploid
GACCGTGCTGACGGTG-1	diploid
GACCGTTACATGCGAC-1	aneuploid
GACCTGGTCTGGGCGT-1	aneuploid
GACCTTCCACGTCTAC-1	diploid
GACGACGATCCGCGTT-1	diploid
GACGACTTTCCAAGAA-1	aneuploid
GACGAGGCTAATAAAC-1	diploid
GACGATATCACTGGGT-1	diploid
GACGCATACCCGTCGG-1	diploid
GACGCCGTAAAGGCTA-1	diploid
GACGCCTGTTGCAGGG-1	aneuploid
GACGCTTGCTTCTAAA-1	aneuploid
GACGGGATGTCTTATG-1	aneuploid
GACGGTCAATAGAAGC-1	diploid
GACGTGAGACTCCATG-1	aneuploid
GACGTTCGTAAATACA-1	diploid
GACGTTGCTCGGCGGC-1	diploid
GACTAACACAGCACCT-1	aneuploid
GACTAAGATCATGCAC-1	aneuploid
GACTAAGTAGGCTCAC-1	aneuploid
GACTACAAAGCGGTGG-1	diploid
GACTACAATTGCTCGT-1	aneuploid
GACTAGGCCGTTAGGT-1	diploid
GACTCACCCACGTGAG-1	diploid
GACTCCCAGAATAAGG-1	diploid
GACTCCTTCCAATTGA-1	diploid
GACTCGCGGGAATGAC-1	diploid
GACTCGGTCGGCGGAT-1	aneuploid
GACTCTAGAGTTCCAA-1	diploid
GACTGATTGGTCACAA-1	aneuploid
GACTGCAAATCGAGCT-1	diploid
GACTGCACCAGCCCAG-1	diploid
GACTGCGGCACGTGTA-1	aneuploid
GACTGCTGGTGAGAAA-1	diploid
GACTGGGCGCCGCAAC-1	aneuploid
GACTTCAACGCATCAA-1	diploid
GAGAACGGTTCTGACT-1	diploid
GAGAATCTCACGATCA-1	aneuploid
GAGACCCTGCAACGCC-1	aneuploid
GAGACTGATGGGTAGA-1	aneuploid
GAGACTTCGCGACCGA-1	diploid
GAGAGCGCAGTCCCTG-1	aneuploid
GAGAGGCCTATGTGTA-1	diploid
GAGAGGGCGCGAGGTT-1	aneuploid
GAGAGGTGCATTCTGG-1	aneuploid
GAGAGTCTCGGGAGAG-1	diploid
GAGATCGATCTTACTC-1	diploid
GAGATCTGCTTGGCAT-1	aneuploid
GAGATCTGTCACTCCG-1	diploid
GAGATCTTCCATGACA-1	diploid
GAGATGACAATCCTTA-1	diploid
GAGATGGCTTTAATCA-1	diploid
GAGATGGGAGTCGACA-1	diploid
GAGCACCTGTGTCCAG-1	diploid
GAGCACGGCGCCTCTT-1	diploid
GAGCATCAACAACTTG-1	diploid
GAGCATCATCCCTGGG-1	aneuploid
GAGCCACGGTAGTAGG-1	aneuploid
GAGCCAGCTACCTGTG-1	diploid
GAGCCGAGCGTTTATT-1	aneuploid
GAGCGAGGGAGTACCG-1	aneuploid
GAGCGCAAATACTCCG-1	diploid
GAGCGCGCACGAGTAG-1	diploid
GAGCGCTATGTCAGGC-1	aneuploid
GAGCGCTGTTAGGTAA-1	diploid
GAGCGGAATGCGGTGT-1	diploid
GAGCTAAGGGCATATC-1	diploid
GAGCTCAACATGAGCG-1	diploid
GAGCTCTCGGACCTAA-1	aneuploid
GAGCTGTCGTCTCGGA-1	diploid
GAGGAATATCTCTTTG-1	diploid
GAGGAATGGAGAGGTT-1	aneuploid
GAGGAGATCCTCATGC-1	aneuploid
GAGGAGTAATTCCTAC-1	aneuploid
GAGGATAAACAGTGCT-1	diploid
GAGGCATTTGCAGCAG-1	diploid
GAGGCCCGACTCCGCA-1	diploid
GAGGCCTGTTGATACA-1	diploid
GAGGCTATCAAAGTCG-1	aneuploid
GAGGGAGTCAGATCGC-1	diploid
GAGGGCATCGCGTATC-1	aneuploid
GAGGGCCATAATATTA-1	diploid
GAGGGCCGGCAGAGTC-1	aneuploid
GAGGGCGCAGCTCTGC-1	diploid
GAGGGTAGTAACAAAG-1	diploid
GAGGTACATCCATCTT-1	aneuploid
GAGGTACGCGTGTCCC-1	diploid
GAGGTCCCAAAGATCT-1	aneuploid
GAGGTCTTAGTGGGTC-1	aneuploid
GAGTAAACCGGAAAGT-1	diploid
GAGTAAGGCCACGGGA-1	diploid
GAGTACGGGTATACAA-1	aneuploid
GAGTAGATACTAGTTG-1	diploid
GAGTATACCCTAATCA-1	diploid
GAGTATCAAAGTTACA-1	diploid
GAGTATGCCCGCCTTG-1	diploid
GAGTATGCGCGTGCAT-1	diploid
GAGTCAGACCAGAATC-1	diploid
GAGTCCGCTTACCGGA-1	diploid
GAGTCGACAGACCCTC-1	aneuploid
GAGTCTTGTAAAGGAC-1	aneuploid
GAGTGCACGGACAACA-1	diploid
GAGTGTCAACCAGAAA-1	diploid
GAGTGTGCGGTACCCA-1	diploid
GAGTTCTGTGGGTGCT-1	diploid
GAGTTGATGGCAATTT-1	diploid
GAGTTGTCACCAGTCT-1	diploid
GATAAATCGGTGGATG-1	aneuploid
GATAACTCGCACTGTG-1	diploid
GATAAGGCAGATGCAA-1	aneuploid
GATAAGGGACGATTAG-1	aneuploid
GATACGATGGGAGTCA-1	diploid
GATAGAACCCGCTAGG-1	diploid
GATAGATAGTACAGTC-1	diploid
GATAGCGTACCACGCG-1	aneuploid
GATAGGTAACGTTGAC-1	diploid
GATAGGTGTCCCGGGC-1	diploid
GATAGTGCGAGTAAGT-1	diploid
GATATCAAGCAGGAGC-1	diploid
GATATCAGTATGTATC-1	aneuploid
GATATCTCATGCAATA-1	aneuploid
GATATGAGACACTAAC-1	diploid
GATATGCGGTAGCCAA-1	aneuploid
GATATGGATTACGCGG-1	aneuploid
GATATTGAGATTGGCG-1	diploid
GATATTTCCTACATGG-1	aneuploid
GATCAACATAAAGGGA-1	diploid
GATCATTCCAAACATT-1	aneuploid
GATCCAACCTTTAAAC-1	diploid
GATCCCTTTATACTGC-1	aneuploid
GATCCGAATATAAGTG-1	diploid
GATCCGGGAATTAACA-1	diploid
GATCCTAAATCGGGAC-1	diploid
GATCCTCGACACTGGC-1	diploid
GATCCTCTTGCGCTTA-1	aneuploid
GATCGACACTATCTGA-1	aneuploid
GATCGCGGGCTCTCCA-1	aneuploid
GATCGCTACCCGATTT-1	diploid
GATCGCTATATCTCAG-1	diploid
GATCGGATAGAACCAT-1	aneuploid
GATCGGCGATAAGTCG-1	aneuploid
GATCGGTGGCCATAAC-1	aneuploid
GATCGTGACTGATATC-1	diploid
GATCTAACCGTATTCA-1	diploid
GATCTCGACGCTGTGG-1	diploid
GATCTGCTATCTAAGG-1	diploid
GATCTTAGTGAACGTG-1	aneuploid
GATCTTCATTGTCCTC-1	aneuploid
GATCTTGGAGGGCATA-1	diploid
GATCTTTGCAGGGTAT-1	aneuploid
GATCTTTGCTCAAAGA-1	aneuploid
GATGACAAGTAGGGCA-1	diploid
GATGACGATGATCGCG-1	diploid
GATGAGGAACCTTCGG-1	diploid
GATGATTTGAAACTGG-1	aneuploid
GATGCCACACTACAGC-1	aneuploid
GATGCCAGCAGAAGGC-1	aneuploid
GATGCCTTCTGCGGCA-1	diploid
GATGCGAATGGTATTA-1	aneuploid
GATGCGTCCTGCATTC-1	aneuploid
GATGCTACAAGCGCCT-1	aneuploid
GATGCTACCTTCGATG-1	diploid
GATGCTGTATTTCATC-1	diploid
GATGGCGCACACATTA-1	aneuploid
GATGGTGAAATAACCC-1	aneuploid
GATGGTGCCCTAGGCA-1	aneuploid
GATGTAACGAACCACC-1	diploid
GATGTCCGGATCACAT-1	aneuploid
GATGTCGGTCAACTGC-1	aneuploid
GATGTGTTGTCACAAG-1	aneuploid
GATGTTCAATCCACGA-1	diploid
GATGTTTGTGCGAGAT-1	aneuploid
GATTAACCGAAAGCCC-1	diploid
GATTAATCCTGGCTCA-1	aneuploid
GATTACTGAATTTGGG-1	aneuploid
GATTAGAAACAAGCGT-1	diploid
GATTCCCTTGTCGCAG-1	aneuploid
GATTCCGCGTTTCCGT-1	aneuploid
GATTCCTATACGGCGC-1	aneuploid
GATTCGACGGTTCACG-1	diploid
GATTCTGTTAATGAGT-1	diploid
GATTGACACTCTGCTC-1	aneuploid
GATTGCTCCAGTTGCA-1	diploid
GATTGGGAAAGGTTGT-1	diploid
GATTTAGTGCGTACTG-1	diploid
GATTTGCGCTAACACC-1	diploid
GCAAACCCTACATTAT-1	diploid
GCAAACCTTGGCCATA-1	diploid
GCAAACGTAAGCGACC-1	diploid
GCAAACGTCGCCAGGT-1	diploid
GCAAAGGGCGTTAGCC-1	diploid
GCAAATATTACGCTTT-1	aneuploid
GCAAATGAGGACACTT-1	aneuploid
GCAACACACTAGAACT-1	aneuploid
GCAACAGCAGTATGCG-1	diploid
GCAACCACCAGACCGG-1	aneuploid
GCAACCACGGCCGCGT-1	aneuploid
GCAACCCAAGTTGTTT-1	aneuploid
GCAACGGCTAGTTATG-1	diploid
GCAAGAATTCCTTGGC-1	aneuploid
GCAAGATGTGTTCGCG-1	aneuploid
GCAAGCTGGAAACCGC-1	diploid
GCAAGTGCACAGAGAA-1	aneuploid
GCAAGTGTAAAGCATG-1	diploid
GCAATTAGTCGCACCG-1	diploid
GCACAAACCCTAGATG-1	diploid
GCACAAACGAGGCGTG-1	diploid
GCACAACCTCGGGCGT-1	diploid
GCACAAGTGGATCATA-1	aneuploid
GCACAAGTGTCGGAAG-1	aneuploid
GCACACACTGGTAGCC-1	diploid
GCACACAGCTATTACC-1	diploid
GCACACGCCCATGGTC-1	aneuploid
GCACAGCACGGGCCGA-1	diploid
GCACCTAGGCGAGTCC-1	diploid
GCACCTTCCCGAAGGT-1	diploid
GCACGCCGATTCCCGC-1	diploid
GCACGCCTACTTAGAT-1	diploid
GCACGTGGTTTACTTA-1	diploid
GCACTAGTCGCGCTAT-1	aneuploid
GCACTCCCACAGTCCC-1	aneuploid
GCACTGCCTACCTTTA-1	diploid
GCACTGTGCAAATGTA-1	aneuploid
GCAGAAACGTAATCCA-1	aneuploid
GCAGAAGGTAATCTCC-1	diploid
GCAGACCCAGCACGTA-1	diploid
GCAGATCCATAAGACT-1	diploid
GCAGATTAGGGATATC-1	diploid
GCAGCACACAGCCCAG-1	aneuploid
GCAGCCTATATCACAT-1	diploid
GCAGCGGTGGGCATTA-1	aneuploid
GCAGCTATGGACAGGT-1	aneuploid
GCAGCTGTCAACGCAT-1	diploid
GCAGGAACTTAGATCT-1	diploid
GCAGGACTATAGAATA-1	aneuploid
GCAGGTAGAGTATGGT-1	aneuploid
GCAGTGTGGCTATAGG-1	diploid
GCAGTTCGATCCGAGC-1	diploid
GCATAAATTGAACGCC-1	aneuploid
GCATACGAGGTCTTTA-1	aneuploid
GCATAGAGCACTCAGG-1	diploid
GCATCCCTAACTTTGA-1	aneuploid
GCATCCTCTCCTATTA-1	aneuploid
GCATGAGGGACGCGGC-1	diploid
GCATGCTAATAACGAT-1	diploid
GCATGGGTACTGACGC-1	aneuploid
GCATTCAAGGCAACGC-1	diploid
GCATTCGAAATGAACA-1	aneuploid
GCATTGACTTGCGGAA-1	diploid
GCATTGTAATTCATAT-1	aneuploid
GCATTTCCAAGGCTCC-1	diploid
GCCAACCATTTCCGGA-1	diploid
GCCAAGAATACTTCTG-1	aneuploid
GCCAATAGGGCATCTC-1	diploid
GCCACAATTTAAGGAC-1	diploid
GCCACCCATTCCACTT-1	aneuploid
GCCACCTTATTCGCGA-1	diploid
GCCACTCAGAGCGCGA-1	diploid
GCCACTCCTTACGGTA-1	diploid
GCCAGGAAAGAACACT-1	diploid
GCCAGGAGTAACCGAT-1	aneuploid
GCCAGGCGTTCGCATG-1	aneuploid
GCCAGGCTTAGTGGTA-1	aneuploid
GCCATATTGCACACAG-1	aneuploid
GCCATCGAGCTGCGTG-1	diploid
GCCATCGATGCTGCAT-1	diploid
GCCATTAGCCTCAAAC-1	diploid
GCCCACCAAGGCTGTC-1	aneuploid
GCCCACTGGTCCACAA-1	aneuploid
GCCCAGATGCTGGAGA-1	diploid
GCCCAGCGACACAAAG-1	diploid
GCCCAGTTGGTATGCC-1	aneuploid
GCCCATGGGTGCAATG-1	aneuploid
GCCCGACTTCTTCCCG-1	aneuploid
GCCCGAGAGTCTAAAT-1	diploid
GCCCGATCTGTGGTCG-1	diploid
GCCCGATGCCCAGTTC-1	diploid
GCCCGCGCGTAAACGG-1	diploid
GCCCGCGCGTTTGACA-1	aneuploid
GCCCGTAATACCTTCT-1	diploid
GCCCGTCAAGCCCAAT-1	diploid
GCCCTAAGTGCAGGAT-1	diploid
GCCCTAGCCGTCGCGA-1	diploid
GCCCTGAGGATGGGCT-1	diploid
GCCGAAATTCCTACGT-1	aneuploid
GCCGACCCACGACTGC-1	diploid
GCCGATTGGCCAAGCT-1	diploid
GCCGCACTCCGTTTCA-1	diploid
GCCGCATTAGTCCGGC-1	aneuploid
GCCGCTAGATACGCAG-1	aneuploid
GCCGCTTGTGAGAAAC-1	aneuploid
GCCGGAAACACATCTT-1	aneuploid
GCCGGGTTAGGGTCGC-1	diploid
GCCGGTCGTATCTCTC-1	diploid
GCCGGTTTGGGCGGAT-1	aneuploid
GCCGTCGGTTTCGGGC-1	diploid
GCCGTGGAAGAAATGT-1	diploid
GCCTACGTTCTGTGCA-1	diploid
GCCTAGCGATCTGACC-1	aneuploid
GCCTATAGTGTCAGGG-1	diploid
GCCTATGCTGGGCCTT-1	diploid
GCCTATTCCGATATAG-1	aneuploid
GCCTATTTGCTACACA-1	aneuploid
GCCTCAGGTACCGGTC-1	diploid
GCCTCATCTGGAAATA-1	diploid
GCCTCCGACAATTCAC-1	diploid
GCCTCTATACATAGCA-1	diploid
GCCTGCTACACTGAGA-1	aneuploid
GCCTGTCCCGGTGCAT-1	diploid
GCCTTCAGCCCTACCG-1	aneuploid
GCCTTGTATATGCAGT-1	aneuploid
GCCTTTGTCAGTGGAC-1	diploid
GCGAAACGATCGGGAG-1	diploid
GCGAAACTTAACTGGA-1	diploid
GCGAAGAATCTGACGG-1	diploid
GCGAAGCCATACCCGT-1	aneuploid
GCGAATGGACTAGCGA-1	diploid
GCGACATGTAAACATC-1	diploid
GCGACCCAACCATCTG-1	diploid
GCGACGATAGTTGTAC-1	diploid
GCGACGGTAGTCTCCT-1	diploid
GCGAGAAACGGGAGTT-1	aneuploid
GCGAGAGGCCATGTAA-1	diploid
GCGAGAGTTGCGTCCA-1	diploid
GCGAGCGCATGCTCCC-1	diploid
GCGAGGCCCGAGCAGA-1	aneuploid
GCGAGGGACTGCTAGA-1	aneuploid
GCGAGTTCTGCAAAGA-1	aneuploid
GCGATGTCTGTGCTTG-1	aneuploid
GCGATTCTGGAAGCAG-1	aneuploid
GCGATTGTTAACGTTA-1	diploid
GCGCAAATATATTCAA-1	diploid
GCGCAAGAGCGCGCTG-1	diploid
GCGCATCCAGTCAGCA-1	diploid
GCGCCGTTCCACGATA-1	diploid
GCGCCTCCCACTCCGA-1	diploid
GCGCGATGGGTCAAGT-1	aneuploid
GCGCGGTCTAGTAACT-1	diploid
GCGCGTCATTGGTACA-1	diploid
GCGCGTTTAAATCGTA-1	aneuploid
GCGCTAAGTATGCATG-1	aneuploid
GCGCTAATTGAATAGA-1	diploid
GCGCTATGCCGAGGCA-1	diploid
GCGCTGATCCAGACTC-1	aneuploid
GCGCTGCTTTGCATTT-1	diploid
GCGCTGGCGGAAAGTC-1	aneuploid
GCGCTTAAATAATTGG-1	diploid
GCGGACCGCGTTGTGG-1	diploid
GCGGAGAAACTTCGCA-1	diploid
GCGGAGAGGGAGAACG-1	diploid
GCGGCAAAGTATTGCC-1	diploid
GCGGCTCTGACGTACC-1	aneuploid
GCGGCTTTAGCAAGTT-1	diploid
GCGGGAACCAGGCCCT-1	aneuploid
GCGGGCAGACGGGTGA-1	diploid
GCGGGCATTACGATGC-1	diploid
GCGGGCGAGCCTTACC-1	diploid
GCGGTAACCCAAATGA-1	aneuploid
GCGGTCCCGGTGAAGG-1	diploid
GCGGTCCCTAGACGCA-1	aneuploid
GCGGTCTTGCTTTCAC-1	diploid
GCGGTGAACTGCGCTC-1	aneuploid
GCGGTGCGGAGCATCG-1	aneuploid
GCGGTTCCCTATCATG-1	diploid
GCGTAAATGGCCATAA-1	diploid
GCGTCCAGCTCGTGGC-1	aneuploid
GCGTCCCTAAGACATA-1	diploid
GCGTCGAAATGTCGGT-1	aneuploid
GCGTCGCCAGGGTGAT-1	diploid
GCGTCGTAACATGGTC-1	diploid
GCGTCTAACCTCCTAA-1	diploid
GCGTCTCTGCATTGGG-1	aneuploid
GCGTGGTACTGGGTTA-1	diploid
GCGTTATATTTGGAAC-1	aneuploid
GCGTTCGGAGACCGGG-1	diploid
GCTAAACCTGAGGTGA-1	aneuploid
GCTAACTGAAGTCTGA-1	diploid
GCTAAGCCCAGTATGC-1	diploid
GCTAAGTAAAGGCGAT-1	aneuploid
GCTAATACCGAATGCC-1	aneuploid
GCTACAATCGAGGATA-1	diploid
GCTACACTGTCCGAAC-1	aneuploid
GCTACAGTACGGACCG-1	aneuploid
GCTACGACTTATTGGG-1	diploid
GCTACTATAGTAGAGT-1	diploid
GCTAGACCGTCTACTG-1	diploid
GCTAGAGTAGAGATGT-1	diploid
GCTAGCACCTGGGCCA-1	diploid
GCTAGCAGGGAGTGGG-1	aneuploid
GCTAGCGATAGGTCTT-1	diploid
GCTAGCTTGAATAGCT-1	diploid
GCTAGGCACCACGGAG-1	diploid
GCTAGTAGAGCTTGTA-1	diploid
GCTAGTTTCATTGAGG-1	aneuploid
GCTATACGTCTCGGAC-1	diploid
GCTATCATACTCATGG-1	diploid
GCTATCGCGGCGCAAC-1	aneuploid
GCTATGCCAGCTTATG-1	aneuploid
GCTCAACCTCTTAGAG-1	aneuploid
GCTCAATGTAATACCG-1	diploid
GCTCATTACTGCATGT-1	diploid
GCTCATTGATCATATC-1	diploid
GCTCCATGCAAAGCAA-1	diploid
GCTCCCAGTCGGTCCA-1	diploid
GCTCCGCTCGCTTCAG-1	diploid
GCTCCGGACGTTGATA-1	aneuploid
GCTCCTGACATACTGG-1	diploid
GCTCGACCGAACTGAA-1	aneuploid
GCTCGCGGTTCCGCTC-1	aneuploid
GCTCGCTCATGTCCAA-1	diploid
GCTCGGAATTTAAAGC-1	aneuploid
GCTCTAAACCCTGACG-1	aneuploid
GCTCTATGTTACGTGC-1	aneuploid
GCTCTCGGGTACCGAA-1	aneuploid
GCTCTTTCCGCTAGTG-1	diploid
GCTGAACTCTCCAGGG-1	diploid
GCTGAAGGGTTCTTGG-1	diploid
GCTGAATCTTCCAATC-1	diploid
GCTGAGCAACGGTTCT-1	aneuploid
GCTGAGGCGTGAGTAT-1	diploid
GCTGCACGGTTTCTTA-1	diploid
GCTGCGAAGAATTATT-1	diploid
GCTGCGCCTCCCACGT-1	aneuploid
GCTGCTAAGTAGTCGA-1	diploid
GCTGCTACTGCGTAGC-1	diploid
GCTGCTCTCCGGACAC-1	aneuploid
GCTGGACCCAAAGTGG-1	diploid
GCTGGCATATTCACCT-1	aneuploid
GCTGGCGGCGCATGCT-1	diploid
GCTGGGAGCGCGTCAA-1	diploid
GCTGGGTCCGCTGTTA-1	aneuploid
GCTGGTGACTCGTAGT-1	aneuploid
GCTGGTTTAGGCCATA-1	diploid
GCTGTATTACTGGCCC-1	aneuploid
GCTGTCTGTGATCGAC-1	aneuploid
GCTGTTGCTACCGAAC-1	diploid
GCTTAATGTAACTAAC-1	diploid
GCTTACGTAGTTAGTA-1	diploid
GCTTAGGGAAGCGGTA-1	diploid
GCTTATGAAGCAGGAA-1	diploid
GCTTCAGTGGGATTAC-1	aneuploid
GCTTCCAGCTTAGATT-1	aneuploid
GCTTCCATGTAACCGC-1	diploid
GCTTCCCGTAAGCTCC-1	diploid
GCTTCCGTCCCTAGAC-1	diploid
GCTTCGACGTTCAATC-1	diploid
GCTTGAGTGACCTCTG-1	diploid
GCTTGATGATAATCAG-1	aneuploid
GCTTGCAGCACAATTG-1	diploid
GCTTGGATCGATTAGG-1	diploid
GCTTTACACAACTGGG-1	diploid
GCTTTCAGAGGAGGTG-1	diploid
GCTTTCTATCTCAACT-1	aneuploid
GCTTTGCTGCCGGGTA-1	aneuploid
GGAAACAGAGCTTGGG-1	diploid
GGAAACCTTGTTGAAT-1	diploid
GGAAACTAAATGGGCC-1	diploid
GGAAAGGGAATTGAGC-1	diploid
GGAAAGTCTTGATTGT-1	diploid
GGAAAGTGCCCATGCC-1	aneuploid
GGAACCCGAACAAGAA-1	aneuploid
GGAACCGTGTAAATTG-1	diploid
GGAACCTTGACTCTGC-1	diploid
GGAACGGCCTGCAGCC-1	aneuploid
GGAACTTTGGCGATTA-1	diploid
GGAAGATAAGACTGTA-1	aneuploid
GGAAGCTCGCTTACAG-1	aneuploid
GGAAGGACACCGTATA-1	diploid
GGAATGCGCTAGCGTG-1	diploid
GGACAACCATGAAGCC-1	diploid
GGACAAGCCATGATCG-1	diploid
GGACAAGTTGCAGTGA-1	aneuploid
GGACACAAGTTTACAC-1	diploid
GGACACCTCGGTGTTG-1	diploid
GGACCAACAGGATAAC-1	diploid
GGACCTACGGTAACGT-1	diploid
GGACCTCTAGGCCGCC-1	diploid
GGACGGCTTGCGCAAC-1	aneuploid
GGACGGGCGACCAACC-1	diploid
GGACGTCCATAGTTGG-1	aneuploid
GGACTAAGTCAGGAGT-1	aneuploid
GGACTCACAAATTAGG-1	diploid
GGACTCGACAGCGCAT-1	diploid
GGACTCTTTGACTAAG-1	diploid
GGAGAAGTCATTGGCA-1	aneuploid
GGAGACATTCACGGGC-1	aneuploid
GGAGACCAATGTGCTT-1	diploid
GGAGACCATCTACATA-1	diploid
GGAGACGACACCTTTG-1	diploid
GGAGCAACATTTCAAG-1	diploid
GGAGCACCAAGAACTA-1	aneuploid
GGAGCGAGGCCTACTT-1	diploid
GGAGGAGTGTGTTTAT-1	aneuploid
GGAGGATTGAAAGGAG-1	aneuploid
GGAGGCCGAAGTCGTC-1	diploid
GGAGGCGAAGAACCGC-1	aneuploid
GGAGGGTCAAGTAAGA-1	diploid
GGAGTACACATGAGCT-1	aneuploid
GGAGTGCCGCCCTGGA-1	aneuploid
GGAGTTGATTCTGTGT-1	diploid
GGATACTCATGAATTG-1	aneuploid
GGATCAAAGGACGAGG-1	aneuploid
GGATCAGAGCCATCAG-1	aneuploid
GGATCATCCCGTACGC-1	aneuploid
GGATCCCTACCAGCTA-1	aneuploid
GGATCTTGACTCAACC-1	diploid
GGATGAAGATCGCTGA-1	diploid
GGATGACGCGAGTTTA-1	aneuploid
GGATGCTGGCGTTCCT-1	aneuploid
GGATGGCTTGAAGTAT-1	diploid
GGATGTCCTTACCGCA-1	diploid
GGATTAAGCTAAGGTC-1	aneuploid
GGATTAATCATGGACC-1	diploid
GGATTCAGTACGGTGG-1	aneuploid
GGATTCCGCTATACCC-1	aneuploid
GGATTGAAGTAGCCTC-1	diploid
GGATTGCTGTGACTCC-1	diploid
GGATTTCACTTCTATA-1	diploid
GGCAAAGGCGCCAATA-1	diploid
GGCAAATTACTTTACT-1	diploid
GGCAAGCCAGGGATAG-1	diploid
GGCAAGCCCATAGTGG-1	diploid
GGCAAGGCGAAATAGC-1	diploid
GGCAATAGTCAATGAG-1	aneuploid
GGCACGCTGCTACAGT-1	diploid
GGCACTCAGCCGACCC-1	diploid
GGCACTCCACTGGGCA-1	aneuploid
GGCACTGCGGTGGTTT-1	diploid
GGCAGAGAGATCGGGA-1	aneuploid
GGCAGCAAACCTATGC-1	diploid
GGCAGCGGTAATCCTA-1	aneuploid
GGCATACAGGTAGCGG-1	aneuploid
GGCATATCGGTTCTGC-1	aneuploid
GGCATCAACGAGCACG-1	aneuploid
GGCATTGAACATCTCA-1	diploid
GGCCAATTGTATAGAC-1	diploid
GGCCACAAGCGATGGC-1	aneuploid
GGCCACACGAAAGCCT-1	aneuploid
GGCCCAATCTAGAGGG-1	aneuploid
GGCCCAGCTGGTTTGC-1	diploid
GGCCCAGTTATCAGCA-1	aneuploid
GGCCCGGAGCATGTCT-1	diploid
GGCCCGTATACCATGC-1	diploid
GGCCCTCACCCACTTA-1	aneuploid
GGCCGAGACTCTGGTG-1	diploid
GGCCGCAGGAACCGCA-1	diploid
GGCCGGCGTCTGCTAT-1	diploid
GGCCGTTTGGGTTTCA-1	diploid
GGCCTGCTCTGATGTT-1	diploid
GGCCTGCTTCTCCCGA-1	diploid
GGCCTTTGCAACTGGC-1	aneuploid
GGCGAAATCTAACTTG-1	diploid
GGCGAACCGTTCTGAT-1	diploid
GGCGAGCATCGAGGAC-1	aneuploid
GGCGAGCGAAACGGCA-1	diploid
GGCGCAGGACATCTTC-1	aneuploid
GGCGCGGAGATCTTTC-1	diploid
GGCGCGTTCGAGTTTA-1	diploid
GGCGCTCCTCATCAAT-1	aneuploid
GGCGCTTCATTCCCTG-1	diploid
GGCGGAGTAATATTAG-1	aneuploid
GGCGGTAGGATCATTG-1	aneuploid
GGCGGTTTGCCGGTGC-1	aneuploid
GGCGTACCCTATATAA-1	aneuploid
GGCGTAGGGAAAGCTG-1	diploid
GGCGTCCTATCCGCTG-1	aneuploid
GGCTAAAGGGCGGGTC-1	aneuploid
GGCTAATGATTGAAAT-1	aneuploid
GGCTACTATACACTCC-1	diploid
GGCTATTAAGTTGTAT-1	aneuploid
GGCTCCTCCACCTGTT-1	diploid
GGCTCGCGTTGAGGTA-1	diploid
GGCTCGTGCCACCAGC-1	aneuploid
GGCTCTGCTCCAACGC-1	aneuploid
GGCTGAAATAGCAAAG-1	diploid
GGCTGAGCATCGTAAG-1	aneuploid
GGCTGGCAGCTTTATG-1	aneuploid
GGCTGGCTAGCTTAAA-1	aneuploid
GGCTGTCCTACTGCGG-1	diploid
GGCTTCTCGTGGGTGG-1	diploid
GGCTTGGCTCTCACCT-1	aneuploid
GGCTTTCAATAAGGGT-1	diploid
GGGAAAGAATGCCAAC-1	diploid
GGGAACCACCTGTTTC-1	aneuploid
GGGAACGGGAGGTTAG-1	aneuploid
GGGAACGGTTTCAGAT-1	diploid
GGGAAGACGGTCTGTC-1	diploid
GGGAAGGGCTTTCTCA-1	diploid
GGGAATGAGCCCTCAC-1	diploid
GGGAATTCTGTCCAGT-1	aneuploid
GGGACAGAGTTACTCC-1	diploid
GGGACCCGTATATCTT-1	diploid
GGGACTGCATAGATAG-1	aneuploid
GGGAGAACTCACAGTA-1	aneuploid
GGGAGCGACCGTAGTG-1	diploid
GGGAGGATGCCCGAAA-1	aneuploid
GGGAGTAATGGCTGGC-1	aneuploid
GGGATACGGTAATAAT-1	aneuploid
GGGATATTGATCGCCA-1	diploid
GGGATCCCAATACAAA-1	diploid
GGGATGGACCCGCGTC-1	diploid
GGGATGGTCGTAACCG-1	diploid
GGGATTATCTCACAAC-1	aneuploid
GGGATTTACCGCACCT-1	diploid
GGGCAACCGCACGTGC-1	diploid
GGGCACGAATTGGCCG-1	aneuploid
GGGCACGTAGTACTGT-1	diploid
GGGCACTATTGACCAT-1	diploid
GGGCAGACGTCACTGC-1	diploid
GGGCAGGATTTCTGTG-1	diploid
GGGCAGTCAACGCCAA-1	diploid
GGGCATGCATGTCGAG-1	diploid
GGGCCATTCGTGCTGG-1	diploid
GGGCCCGTCTTAAACA-1	diploid
GGGCCCTACGAAAGGG-1	aneuploid
GGGCCCTTATCTATAC-1	aneuploid
GGGCCGGCCGAAGTAC-1	diploid
GGGCCTAAATGGGCTA-1	aneuploid
GGGCCTATACAACCGG-1	aneuploid
GGGCCTATTTAAGTAT-1	aneuploid
GGGCGAATTTCTCCAC-1	aneuploid
GGGCGATATGTGTGAA-1	aneuploid
GGGCGATCCATAGGCC-1	diploid
GGGCGCAGCGTTACTC-1	diploid
GGGCGGCAAATGAATT-1	diploid
GGGCGGGTTCCCTACG-1	aneuploid
GGGCGGTCCTATTGTC-1	aneuploid
GGGCGTACATTTATAT-1	aneuploid
GGGCGTCACCACGTAA-1	diploid
GGGCGTCCACTGGCTC-1	aneuploid
GGGCGTGGTTTCCCAG-1	diploid
GGGCGTTTACATTCAT-1	diploid
GGGCTACTATTTCGTG-1	diploid
GGGCTATGATCGATGG-1	diploid
GGGCTCATCGAACCCA-1	aneuploid
GGGCTGCCTAGGGCGA-1	aneuploid
GGGCTGGTTAGTCGCG-1	aneuploid
GGGTAATGCTGTGTTT-1	aneuploid
GGGTACACTCTGGAGG-1	aneuploid
GGGTACCCACGGTCCT-1	aneuploid
GGGTACTTCATGAACT-1	aneuploid
GGGTATGTATGCACTT-1	aneuploid
GGGTATTCTAGCAAAC-1	diploid
GGGTCACCGTGACGGT-1	aneuploid
GGGTCACGTGCTTATG-1	aneuploid
GGGTCACTGAGTAGTG-1	aneuploid
GGGTCAGGAGCTAGAT-1	diploid
GGGTCATGCGTACCAT-1	aneuploid
GGGTCCTTGGAAGAAG-1	diploid
GGGTCGTGGCAAGTGT-1	diploid
GGGTCTATCGCTTTCC-1	diploid
GGGTGACACCTTAACT-1	diploid
GGGTGCATATGAAAGC-1	diploid
GGGTGGTCCAGCCTGT-1	aneuploid
GGGTGTTTCAGCTATG-1	aneuploid
GGGTTAACATTTGAGT-1	diploid
GGGTTCAGACGAACAA-1	aneuploid
GGGTTTAGGATAGGAT-1	diploid
GGGTTTCCGGCTTCCA-1	aneuploid
GGTAAACTCTGCGCTG-1	diploid
GGTAAATGTGCGTTAC-1	aneuploid
GGTAACCGGCAAAGGT-1	aneuploid
GGTAACCGGGAGGATA-1	diploid
GGTAACTATGTATCTG-1	aneuploid
GGTACAAACATGCTAT-1	diploid
GGTACACCAGATTTAT-1	diploid
GGTACATCTGGGACGA-1	aneuploid
GGTACCATTAAGACGG-1	diploid
GGTACGTTGCGGCCGG-1	diploid
GGTACTAAGTGCTTTG-1	diploid
GGTAGACCGTTGGGCG-1	diploid
GGTAGGCCAATATCAC-1	diploid
GGTAGTGCTCGCACCA-1	diploid
GGTATAGTGACACATA-1	diploid
GGTATCAAGCATAGAA-1	aneuploid
GGTATGAAAGAACTGA-1	aneuploid
GGTATTGCCGAGTTTA-1	aneuploid
GGTCAAGACTACTTCG-1	diploid
GGTCACGTTAGATTCA-1	aneuploid
GGTCAGTGGGTCCCAC-1	diploid
GGTCATTGTAGTCATA-1	diploid
GGTCCACGTCTATTTG-1	diploid
GGTCCCATAACATAGA-1	aneuploid
GGTCCTTCATACGACT-1	aneuploid
GGTCGGATAAACGGCG-1	diploid
GGTCGGCCAGGAGCTT-1	diploid
GGTCGGTAATTAGACA-1	aneuploid
GGTCGGTCGTCCACAG-1	diploid
GGTCGTAAGCTCGCAC-1	diploid
GGTCTCCGTCCAGGTT-1	diploid
GGTCTGAGAATCTGGA-1	diploid
GGTCTTGAGCGCTCTT-1	diploid
GGTCTTGGTGTTAACT-1	aneuploid
GGTGAAACCGGGAATG-1	aneuploid
GGTGAACGGGCTAGCC-1	aneuploid
GGTGAAGTACAGGGAT-1	aneuploid
GGTGAGATGCAGATAA-1	aneuploid
GGTGATAAGGAGCAGT-1	aneuploid
GGTGATGAAGGAAGTG-1	aneuploid
GGTGATTTCATCTTGT-1	aneuploid
GGTGCAGAGCCTATCG-1	aneuploid
GGTGCATAAATGATTA-1	diploid
GGTGCGGATAAGTGGC-1	aneuploid
GGTGCTGATCACAAAG-1	aneuploid
GGTGCTGGTACACATT-1	diploid
GGTGGACCACGTGTTA-1	aneuploid
GGTGGACTGCTCTGGC-1	diploid
GGTGGAGGTTGATACG-1	diploid
GGTGGGATTAGGTCCC-1	diploid
GGTGTAAATCGATTGT-1	diploid
GGTGTAGGTAAGTAAA-1	diploid
GGTGTTCTGTTTCTAC-1	aneuploid
GGTGTTGGGCGTCTTA-1	diploid
GGTTACCACCCTCGGG-1	aneuploid
GGTTACCCGACACTTT-1	diploid
GGTTAGCTATATGTCT-1	diploid
GGTTAGGCTTGGAGAA-1	aneuploid
GGTTAGGGATGCTAAT-1	diploid
GGTTAGTTACGGCGCC-1	aneuploid
GGTTCCACCCGCTTCT-1	aneuploid
GGTTCCCTAGTGTCTC-1	aneuploid
GGTTCGATGCTGAGTT-1	aneuploid
GGTTCGCATTTGCCGT-1	diploid
GGTTCGGATTATACTA-1	aneuploid
GGTTCTACTCGTCTGA-1	diploid
GGTTGTATCGTGAAAT-1	aneuploid
GGTTGTGCTCTTGTCC-1	aneuploid
GGTTGTGTAGCCTGGC-1	aneuploid
GGTTTAATTGAGCAGG-1	diploid
GGTTTACAATCTCAAT-1	diploid
GGTTTAGCCTTTCTTG-1	diploid
GGTTTCAATCGGTCAG-1	diploid
GGTTTGACAAGAAGCT-1	aneuploid
GGTTTGAGTGCTGGAA-1	aneuploid
GGTTTGCGAACACGTA-1	diploid
GGTTTGTGACCTGAGG-1	diploid
GTAACAACTGACCTTG-1	aneuploid
GTAACAGGTTAACGGC-1	diploid
GTAACATCAGCTCATC-1	aneuploid
GTAACATCTAAGATAA-1	diploid
GTAACTACGTAGACCT-1	diploid
GTAACTGCCCAAGGAG-1	diploid
GTAACTTGCGGCAGTC-1	aneuploid
GTAAGCGGGCAGTCAG-1	aneuploid
GTAAGGATTTGTCGGA-1	aneuploid
GTAAGTAACAGTCTGG-1	diploid
GTAAGTAGGGTATACC-1	aneuploid
GTAAGTCCACACTCTA-1	diploid
GTAATAAAGGGCTCCC-1	aneuploid
GTAATCTGATTCTTCG-1	diploid
GTACACTTACCTGAAG-1	diploid
GTACAGAGGCAAGGGT-1	diploid
GTACGACGGCGCTGCG-1	aneuploid
GTACGAGATTGCGACA-1	aneuploid
GTACGCTTCATTGCAC-1	diploid
GTACGTCACGTATTAA-1	aneuploid
GTACGTTTGCCCGTCA-1	diploid
GTACTAAGATTTGGAG-1	aneuploid
GTACTACGGCCTCGTT-1	diploid
GTACTCCCTTATCGCT-1	aneuploid
GTACTCCTGGGTATGC-1	diploid
GTACTGAGGTCGTAAC-1	aneuploid
GTACTGCATGAAGCGT-1	aneuploid
GTACTGGAGTTAGACC-1	diploid
GTACTTGGGCACTTCT-1	aneuploid
GTAGAAACGGGTGGAG-1	aneuploid
GTAGACAACCGATGAA-1	aneuploid
GTAGACACGCCTGACT-1	diploid
GTAGACGTCGTTACAT-1	aneuploid
GTAGAGGGAGACAAGT-1	diploid
GTAGCCAAACATGGGA-1	diploid
GTAGCGCTGTTGTAGT-1	aneuploid
GTAGCGGCTATACACT-1	diploid
GTAGCTAGTAAGCGCG-1	aneuploid
GTAGCTTCCTCTTGTT-1	diploid
GTAGGTGATCCGTGTA-1	aneuploid
GTAGTCTACGATATTG-1	diploid
GTAGTGAGCAACCTCA-1	diploid
GTAGTTAGACAATATA-1	aneuploid
GTAGTTCGAAGGCGAA-1	diploid
GTAGTTTAAGCACACG-1	diploid
GTATAGGACTCAGTAG-1	aneuploid
GTATAGTGGCCCATGT-1	aneuploid
GTATATGTTACGGCGG-1	aneuploid
GTATCAAACGTTAGCT-1	diploid
GTATCAAGGTACTTCC-1	diploid
GTATCAGCTTGGGTTC-1	aneuploid
GTATCCTTTGGTAACC-1	diploid
GTATCGGGACGAGCTG-1	aneuploid
GTATCTCAGTCTTGAC-1	diploid
GTATCTCCCTAACTGT-1	aneuploid
GTATCTTGTTGCTCAC-1	aneuploid
GTATCTTTCATAACCA-1	diploid
GTATGAAATTTCACTC-1	diploid
GTATGACGTGGGAAAC-1	aneuploid
GTATGTGGGTCTAGTT-1	diploid
GTATTAAGGCGTCTAA-1	diploid
GTATTAGGGTTCGCGT-1	aneuploid
GTATTCTGAGAAACGA-1	diploid
GTATTCTTACCGTGCT-1	diploid
GTATTTAATGGCATAA-1	diploid
GTCAAAGAAGTGGTGT-1	diploid
GTCAAAGTTTACATAG-1	aneuploid
GTCAACCAGGCCTATA-1	diploid
GTCAAGCGGACTCGGG-1	diploid
GTCAATGCTATAATTT-1	diploid
GTCAATTGTACTGAAG-1	aneuploid
GTCACAAAGTTTCCAA-1	aneuploid
GTCACCTGTCTATGTC-1	aneuploid
GTCACTCATGAGCGAT-1	diploid
GTCACTCTCCAAATCT-1	aneuploid
GTCAGAATAGTCTATG-1	aneuploid
GTCAGACAGCGTTGGA-1	aneuploid
GTCAGTTGTGCTCGTT-1	aneuploid
GTCAGTTTGGTAGTCG-1	aneuploid
GTCATCTCCTACAGCT-1	diploid
GTCATGCACCTCCGTT-1	aneuploid
GTCATGCGCGAGGGCT-1	diploid
GTCATGGACATGACTA-1	aneuploid
GTCATTAGAGCGAACG-1	diploid
GTCATTGCATTGACCC-1	aneuploid
GTCCAATATTTAGCCT-1	diploid
GTCCACGTCGCATTCG-1	diploid
GTCCAGGCACGTGTGC-1	diploid
GTCCATTACTGCTACG-1	diploid
GTCCCAACGTAAAGTA-1	diploid
GTCCCAATCATCCCGC-1	aneuploid
GTCCCGCGACGTTATG-1	diploid
GTCCGAGAGCAATCAT-1	aneuploid
GTCCGGACCTGAAATT-1	diploid
GTCCGGCTGAATTGCG-1	aneuploid
GTCCGGGTTCACATTA-1	diploid
GTCCGTTAGAGGGCCT-1	diploid
GTCCTACAGGCGGCTC-1	aneuploid
GTCCTACGAATAGTCT-1	diploid
GTCCTACTCTACGGGC-1	diploid
GTCCTAGGATACCTTA-1	diploid
GTCCTATTGTTGTGGT-1	aneuploid
GTCCTTCTACAACCCA-1	aneuploid
GTCCTTCTAGTGGGTT-1	aneuploid
GTCCTTTAATGACTTC-1	aneuploid
GTCGAATTTGGGCGCT-1	diploid
GTCGATAGGTGACTTT-1	diploid
GTCGCCGTTGTGTGTT-1	diploid
GTCGCGTAACCCGTTG-1	diploid
GTCGGAAGGATACCAG-1	aneuploid
GTCGGATATCTCAGAC-1	aneuploid
GTCGGATGTAGCGCGC-1	aneuploid
GTCGGGAACATGGTAG-1	aneuploid
GTCGGGAAGCAGAAAC-1	diploid
GTCGTACCATCTCGGG-1	diploid
GTCGTACCTACGATTG-1	aneuploid
GTCGTATTGGCGTACA-1	aneuploid
GTCGTCAATTATAAGG-1	aneuploid
GTCGTCTGGTTGGCTA-1	diploid
GTCGTGTCTGGTCATC-1	diploid
GTCGTTATTCGCTTAT-1	diploid
GTCTAAGATGCCCAGC-1	aneuploid
GTCTAGTGAGCCGCTT-1	diploid
GTCTATACACGCATGG-1	diploid
GTCTATCTGAGTTTCT-1	diploid
GTCTATTGCATGCTCG-1	diploid
GTCTATTGGTTCCGGT-1	diploid
GTCTCAAGGCCCGGCT-1	diploid
GTCTCCCGAGTCCCGT-1	diploid
GTCTCCGCCTCAATAC-1	diploid
GTCTCCTGCCAGTATG-1	diploid
GTCTCGACTAAGTTTG-1	diploid
GTCTCGATCTGCTTTC-1	aneuploid
GTCTCGCCAACACGCC-1	aneuploid
GTCTGCCGACTCGACG-1	diploid
GTCTGGGCGGTCGAGA-1	diploid
GTCTGTAGGTTGAACA-1	diploid
GTCTTACCACGCCAAG-1	diploid
GTCTTAGTACAGCCGG-1	aneuploid
GTCTTCCTCACCTAAG-1	aneuploid
GTCTTGAGGAGCAGTG-1	diploid
GTCTTGTAGCTATTCA-1	diploid
GTGAAACGGCGCCACC-1	aneuploid
GTGAAACGTGCTCCAC-1	aneuploid
GTGAACTCCCATTCGA-1	diploid
GTGAAGATTTCAAGTG-1	diploid
GTGAAGCCGTATAGTC-1	diploid
GTGAAGTCACGACTCG-1	diploid
GTGACAGCTTCCCACT-1	diploid
GTGACCGCACACTACG-1	diploid
GTGACCTAAAGAATAA-1	diploid
GTGACGAGGGTGACCC-1	diploid
GTGACGCAGGTTTCAT-1	diploid
GTGACTTCAGTAGTGC-1	diploid
GTGAGATAACCTTATA-1	diploid
GTGAGCGTGCTGCACT-1	aneuploid
GTGAGGACACTTAAGG-1	diploid
GTGAGGAGCGGTTGAG-1	aneuploid
GTGAGTCGACTAATAG-1	diploid
GTGAGTCTAAGACGGA-1	aneuploid
GTGAGTGGTACAACGC-1	diploid
GTGATCAAGCGTGCAC-1	diploid
GTGATCACTAACGCCT-1	diploid
GTGATCATAGATCTGC-1	diploid
GTGATCCTTGTCATGA-1	diploid
GTGATGCACAACATCT-1	aneuploid
GTGATTCGCCGCTCAA-1	diploid
GTGCAAATCACCAATA-1	aneuploid
GTGCAACAAATGTGGC-1	aneuploid
GTGCACCAGCTTCAAC-1	diploid
GTGCACGAAAGTGACT-1	aneuploid
GTGCCAAACGTTTCGA-1	diploid
GTGCCATCACACGGTG-1	aneuploid
GTGCCCGTTCGGATTC-1	aneuploid
GTGCCGCTTCAAAGGT-1	diploid
GTGCCTAGCTATGCTT-1	aneuploid
GTGCCTCAGTGTACGG-1	aneuploid
GTGCCTGAGACCAAAC-1	diploid
GTGCGAAATCGAACAC-1	diploid
GTGCGACAGGGAGTGT-1	diploid
GTGCGCAGCTTGCTCC-1	aneuploid
GTGCGCTTACAAATGA-1	aneuploid
GTGCGGGACCATCGGC-1	aneuploid
GTGCGGGTCTCCAAAT-1	aneuploid
GTGCGTGTATATGAGC-1	diploid
GTGCTATCCAGCTGGA-1	diploid
GTGCTCAAGTACTGTC-1	aneuploid
GTGCTGCAGATAAGGA-1	aneuploid
GTGCTTACATCAGCGC-1	diploid
GTGGAACCTACATGCG-1	aneuploid
GTGGACCAACCCGATT-1	aneuploid
GTGGACGTGCTGAGAC-1	aneuploid
GTGGAGCATGTCGGCC-1	diploid
GTGGAGCGTTTACCGA-1	diploid
GTGGAGTCGGCGGTTG-1	diploid
GTGGCAAACAGCGGCA-1	diploid
GTGGCCGGTTTCTCGG-1	diploid
GTGGCCTAATATCATT-1	aneuploid
GTGGCGGGCCGTAGCT-1	aneuploid
GTGGCGGTCCCAGCGT-1	aneuploid
GTGGCGTGCACCAGAG-1	aneuploid
GTGGCTGTTTCTGTTC-1	diploid
GTGGGAACAAACCGGG-1	diploid
GTGGGAAGACTGAATC-1	aneuploid
GTGGGCTTAGACACAC-1	aneuploid
GTGGGTACTGAGCGTA-1	diploid
GTGGGTCTTCTTTGCG-1	aneuploid
GTGGTATAGTCTGCCG-1	diploid
GTGGTCAGCGAAGTAT-1	aneuploid
GTGGTGGCCAAGTGAA-1	diploid
GTGGTTACTTCTTTCG-1	diploid
GTGGTTTCCGCCTTTC-1	aneuploid
GTGTACCTTGGCTACG-1	aneuploid
GTGTATGACTTTAAAG-1	aneuploid
GTGTCAGTGTACGTGG-1	diploid
GTGTCCGATAAGGCAT-1	aneuploid
GTGTCGTATAGCGTTC-1	diploid
GTGTCGTATTCACCTT-1	aneuploid
GTGTGAGCCGAGGTGC-1	aneuploid
GTGTGTCGACGTCGCT-1	aneuploid
GTGTTACTATGCGTCC-1	diploid
GTTAACATCACTTAAA-1	diploid
GTTAACTATGTTGTCA-1	diploid
GTTAAGGGTGCGATGT-1	diploid
GTTAAGTTAGAGTGGG-1	diploid
GTTAATAGCGTCATTA-1	diploid
GTTAATGTCTATCTTA-1	aneuploid
GTTACAATTGGTGACG-1	aneuploid
GTTACCAAGGCGTACG-1	diploid
GTTACCTACAACTTGC-1	diploid
GTTACGAAATCCACGC-1	aneuploid
GTTACGGCCCGACTGC-1	aneuploid
GTTACTTTGGGCCTAG-1	diploid
GTTAGAGTGTGCCGCT-1	aneuploid
GTTAGCCCATGACATC-1	diploid
GTTAGCCGTAAATCAA-1	diploid
GTTAGGCTACCCGTTT-1	diploid
GTTATAATACGGTGAA-1	diploid
GTTATATCAGGAGCCA-1	diploid
GTTATATTATCTCCCT-1	diploid
GTTATCAAGCTATCGA-1	diploid
GTTATCACCTTCTGAA-1	diploid
GTTATTAAATACGACC-1	aneuploid
GTTATTAACGTGGGAG-1	aneuploid
GTTCAAATCAGATGTC-1	aneuploid
GTTCAATCTATGTCAA-1	aneuploid
GTTCACAGGAGTCTAG-1	aneuploid
GTTCAGTCGCCAAATG-1	diploid
GTTCATCGTTTGGCTG-1	diploid
GTTCCAAGACAGCGAC-1	aneuploid
GTTCCAGTCTGACCAT-1	aneuploid
GTTCCCGTAAACATAT-1	diploid
GTTCCGTCCGCCTGCA-1	diploid
GTTCGCCATAAGTGCC-1	diploid
GTTCGCTGAGACGTCT-1	diploid
GTTCGGAGCACTCAAC-1	diploid
GTTCGGATCGGGAACA-1	diploid
GTTCGGGCGTACCATT-1	diploid
GTTCGGTGTGGATTTA-1	aneuploid
GTTCGTCTAAAGAACT-1	diploid
GTTCGTCTGGGTCCCT-1	diploid
GTTCGTTGCGGACCAG-1	aneuploid
GTTCTTCCCTCGATGT-1	aneuploid
GTTCTTGTAACTCAAT-1	diploid
GTTGAACCGGTTCCAT-1	diploid
GTTGCACGGAGTTTCG-1	aneuploid
GTTGCCCTAACGGGTG-1	diploid
GTTGCGCTAACATTAC-1	diploid
GTTGCGGACGGTCAGG-1	diploid
GTTGGACCGCATCAGG-1	diploid
GTTGGATTCAGTGGCT-1	aneuploid
GTTGGATTGAGAACAC-1	diploid
GTTGGATTTGCGTTGG-1	aneuploid
GTTGGTCATGCTATCC-1	diploid
GTTGTAGATTTATGAG-1	diploid
GTTGTCGTGTTAGTTG-1	aneuploid
GTTGTTACATTGCGCT-1	aneuploid
GTTGTTGCAAGATGGC-1	diploid
GTTTACGTTCCATCTG-1	diploid
GTTTATGGGATTTAGA-1	aneuploid
GTTTCAAACGAGTTGT-1	diploid
GTTTCATATCGTCGCT-1	aneuploid
GTTTCCTGGAGGGTGA-1	aneuploid
GTTTCTAGAGGCGCGG-1	diploid
GTTTCTGCAGTCTCCC-1	diploid
GTTTCTTGTTAGAGCT-1	diploid
GTTTGACCAAATCCTA-1	aneuploid
GTTTGAGCGGTTATGT-1	aneuploid
GTTTGGCCCAAGTTAT-1	diploid
GTTTGGCCGCTCAGCG-1	aneuploid
GTTTGGCGTCAGGCAC-1	aneuploid
GTTTGGGCTTGTGAGC-1	diploid
GTTTGGGTTTCGCCCG-1	diploid
GTTTGGTAGGGTCAAC-1	diploid
GTTTGGTGATCGGTGC-1	diploid
GTTTGTTAGCCAAGTA-1	diploid
TAAACCCAGGAGGGCA-1	diploid
TAAACGTCGTCAATGA-1	aneuploid
TAAAGACAACCCTTTA-1	diploid
TAAAGAGCCCGAAACC-1	aneuploid
TAAAGCGGTATTTCCA-1	diploid
TAAAGCGTTAGGAGAA-1	diploid
TAAAGCTGCAATAGGG-1	aneuploid
TAAAGGAGAAACTAGT-1	aneuploid
TAAAGTGCACGTCTCG-1	diploid
TAAATCTTTACACCTC-1	diploid
TAAATGAATCCGTTTC-1	aneuploid
TAAATGCCGTCTCATG-1	aneuploid
TAAATTGTGGGTAAAG-1	diploid
TAAATTTAGTAACACC-1	diploid
TAACAAAGGGAGAAGC-1	aneuploid
TAACAATATTTGTTGC-1	aneuploid
TAACAGCGTTTGTGCT-1	diploid
TAACAGGTTCCCTTAG-1	diploid
TAACATACAATGTGGG-1	diploid
TAACATACACGCGATC-1	diploid
TAACCGCCCGCAGTGC-1	aneuploid
TAACCGTCCAGTTCAT-1	aneuploid
TAACCTACCGTCCGAG-1	diploid
TAACCTAGGGAGTCCA-1	diploid
TAACGCTTTGAGAGCG-1	aneuploid
TAACTATCGAAGGTCC-1	aneuploid
TAACTATTACGCCAAA-1	diploid
TAACTCATCCGCGCGG-1	diploid
TAACTCCATGGAGGCT-1	diploid
TAACTGAAATACGCCT-1	diploid
TAAGAGGGACAGGGAC-1	diploid
TAAGATTTAGCGGGAG-1	aneuploid
TAAGCAGGCGACACGC-1	aneuploid
TAAGCCCTTACGACCA-1	aneuploid
TAAGCGCGAATCAAAT-1	diploid
TAAGGAACTTGTGGGA-1	aneuploid
TAAGGCAACATAAGAT-1	aneuploid
TAAGGCATAACATCAA-1	diploid
TAAGGCCCGTCACCCT-1	diploid
TAAGGCTGAATCCCTC-1	diploid
TAAGGGCCTGTCCGAT-1	diploid
TAAGGGCTGGGAGAGG-1	aneuploid
TAAGTAAATGTGCCGC-1	aneuploid
TAAGTAACATCTTGAC-1	diploid
TAAGTCGCCGAGTATC-1	diploid
TAAGTGAATAGTCTAC-1	diploid
TAAGTTGCGACGTAGG-1	diploid
TAATAAACAAGGAGAT-1	aneuploid
TAATACACAGTAGTAT-1	aneuploid
TAATACTAGAACAGAC-1	diploid
TAATAGAACAGAGTTA-1	diploid
TAATAGCTAAATGATG-1	diploid
TAATAGGTCACCAGAA-1	diploid
TAATAGTGACGACCAG-1	aneuploid
TAATATTGAAATTCGC-1	aneuploid
TAATCAGGAATGCTGC-1	aneuploid
TAATCGATCCGTACGT-1	aneuploid
TAATGAAAGACCCTTG-1	aneuploid
TAATGTCGGTTCATGG-1	diploid
TAATTACGTCAGTAGA-1	diploid
TAATTAGATGGATATG-1	aneuploid
TAATTAGGACATCCGT-1	diploid
TAATTCCAATGCTTCA-1	diploid
TAATTGCGCTGATTAC-1	diploid
TAATTGGAATCGGGAA-1	aneuploid
TAATTTCCGTCCAGTA-1	aneuploid
TACAAATTGCGGAGGT-1	aneuploid
TACAACGCACAACTCA-1	diploid
TACAAGCTGTTCACTG-1	aneuploid
TACAAGGGCTTCTTTA-1	diploid
TACAAGTCTCGTGCAT-1	aneuploid
TACAATGAAACCAGCA-1	aneuploid
TACACAGCCGTGGTGC-1	diploid
TACACCGTCGTTAGTC-1	diploid
TACACCTCTTCGAATC-1	diploid
TACAGAAACGGTGGGC-1	diploid
TACATCCCTATCCCTG-1	aneuploid
TACATCTTGTTTCTTG-1	aneuploid
TACATGACCTTATCCG-1	aneuploid
TACATGCCGGAATTGT-1	diploid
TACATTTCTAACGTGC-1	diploid
TACCAAATAGCCCAGA-1	diploid
TACCAATAAAGTACCA-1	diploid
TACCAGAAGTAGGTTC-1	diploid
TACCAGCTAGGTTTAA-1	aneuploid
TACCAGGAATCCCGTC-1	diploid
TACCATGTATTGATTT-1	diploid
TACCGAATAATTGTAA-1	diploid
TACCGATCCAACACTT-1	aneuploid
TACCGCGGACTTGCAG-1	diploid
TACCGGCTCACTGCCC-1	diploid
TACCGGTCGTTTCCAT-1	aneuploid
TACCGTGCCTCGGACC-1	diploid
TACCTACTCCCAGTAT-1	diploid
TACCTATCCCTAGAGG-1	aneuploid
TACCTCACGCTTGTAC-1	aneuploid
TACCTCCACACCAATG-1	diploid
TACCTCTTTACCATCC-1	diploid
TACCTGCTGCACTGTG-1	aneuploid
TACCTTAAGATTTCCC-1	aneuploid
TACGAACACGACTTCA-1	aneuploid
TACGACGCTTGCTGCG-1	diploid
TACGACTGCCTCTTAG-1	diploid
TACGAGAACTTCACGT-1	aneuploid
TACGATCCAAGCCACT-1	aneuploid
TACGATGTTGATCATC-1	aneuploid
TACGCAGTTCTTTCCT-1	diploid
TACGCCGAGGGTACCC-1	diploid
TACGCCTCCATTCCGA-1	diploid
TACGCTATAGAAACCT-1	diploid
TACGCTCCTAGAACTG-1	diploid
TACGCTCGGTATTGGA-1	diploid
TACGGAAGCCAAACCA-1	diploid
TACGGCATGGACGCTA-1	diploid
TACGGGATGCTAGCAG-1	aneuploid
TACGGGTAATAACATA-1	diploid
TACGTAAAGCGGAGTG-1	diploid
TACGTGCAAGGTTCCT-1	diploid
TACGTGCACTATGCTG-1	aneuploid
TACGTGGGCCCAGGGC-1	diploid
TACGTTTACCGGCAAT-1	aneuploid
TACTACGTGCAATGCG-1	diploid
TACTATGGTTCCTCAG-1	diploid
TACTCACAACGTAGTA-1	aneuploid
TACTCATTGACGCATC-1	diploid
TACTCCTCTAGTTGAC-1	diploid
TACTCGGCACGCCGGG-1	aneuploid
TACTCGTTTGAATCAA-1	diploid
TACTCTCCGAACAAAT-1	aneuploid
TACTCTTACTTTACTG-1	diploid
TACTCTTTCGTCTTCA-1	diploid
TACTGAACAGATTTAG-1	diploid
TACTGAGGGAAGAAAG-1	diploid
TACTGCAATCAATTAC-1	diploid
TACTGGACAGCTCGGC-1	aneuploid
TACTGTTTCTCTGGTA-1	diploid
TACTTAAACATGTACA-1	diploid
TACTTGTTAGTAGTCC-1	diploid
TACTTTACTGAGCCGG-1	diploid
TACTTTCCGCACGCCA-1	aneuploid
TAGAAACACAATAGTG-1	aneuploid
TAGAAACCACTAAGTA-1	aneuploid
TAGAAAGGTGGCGCTA-1	diploid
TAGAAATTCACGTATA-1	diploid
TAGAACGCCAGTAACG-1	aneuploid
TAGAATAGCCGATGAA-1	diploid
TAGAATTAAGGGCAAC-1	aneuploid
TAGACGAAACGCCAAT-1	diploid
TAGACGCCCGTACCGG-1	diploid
TAGACTACCTAGCGTT-1	diploid
TAGACTCAGTTGGCCT-1	diploid
TAGAGATCATGCAACT-1	aneuploid
TAGAGCTACGAAGAAC-1	aneuploid
TAGAGGGAGTTTATCT-1	diploid
TAGAGGTTCTACTTGT-1	diploid
TAGAGTCTAAGCGAAC-1	aneuploid
TAGAGTGTTCCGGGTA-1	diploid
TAGATATGGACTGGAA-1	diploid
TAGATCCGAAGTCGCA-1	aneuploid
TAGATGGTTCCTTACT-1	diploid
TAGATTCAAAGTGCGG-1	diploid
TAGATTCCTGGTTATT-1	aneuploid
TAGATTCTCTAGCAAA-1	diploid
TAGCAACCTGTCACAA-1	aneuploid
TAGCAGATACTTAGGG-1	diploid
TAGCAGTAAATACGCG-1	aneuploid
TAGCAGTATGACTAAA-1	diploid
TAGCCAGAGGGTCCGG-1	aneuploid
TAGCCATGATTGCCTA-1	diploid
TAGCCATTTCAAAGTC-1	diploid
TAGCGTCCCTCGATTG-1	diploid
TAGCGTCGAATATTGA-1	aneuploid
TAGCGTTGGGTCTTAC-1	diploid
TAGCTAAGTCCGGGAG-1	aneuploid
TAGCTAGAAGGCATGA-1	diploid
TAGCTAGTGATGATGG-1	diploid
TAGCTCACTGTGTTTG-1	diploid
TAGCTCAGATCCTAGT-1	aneuploid
TAGCTCGCCTGATAAC-1	diploid
TAGCTGATGTGAAGCG-1	aneuploid
TAGGAACAGCCTCCAG-1	aneuploid
TAGGAGGCTCGAGAAC-1	diploid
TAGGATCTTAACCGCA-1	diploid
TAGGCATGTTACGCCA-1	aneuploid
TAGGCCTATATAGTCT-1	diploid
TAGGCGATGAGGTCTC-1	diploid
TAGGCGGCTGCAAAGA-1	diploid
TAGGCTAAAGTGGCAC-1	diploid
TAGGGAGCTTGGGATG-1	diploid
TAGGGTGTTTCAAGAG-1	aneuploid
TAGGTCCAAGTAAGGA-1	aneuploid
TAGGTCGCCGGAACTG-1	diploid
TAGGTGACGATAACCT-1	diploid
TAGGTGAGCCCTACTC-1	aneuploid
TAGGTGCTCGCCTAGC-1	diploid
TAGGTGTTCCACAGAT-1	diploid
TAGGTTCGAGTTCGTC-1	diploid
TAGGTTCTGCTGAGAA-1	diploid
TAGTACCACAACTTTC-1	diploid
TAGTACCTTAGTGGTC-1	aneuploid
TAGTAGCTTATACCAG-1	diploid
TAGTAGTTGCCGGACA-1	diploid
TAGTCCCGGAGACCAC-1	diploid
TAGTCCGCAGAGAATG-1	diploid
TAGTCCGTATGCATAA-1	aneuploid
TAGTCGATCACGGGTT-1	diploid
TAGTCGGGATTCTTCG-1	aneuploid
TAGTCTAACAACGAGA-1	aneuploid
TAGTCTGCGGCACATT-1	diploid
TAGTCTGTGACGTTGC-1	diploid
TAGTCTTTCCGAATTG-1	diploid
TAGTGACAAGCTCTAC-1	diploid
TAGTGAGAAGTGGTTG-1	aneuploid
TAGTGCCCTCCAGAGT-1	aneuploid
TAGTGCTTGAATCCTT-1	aneuploid
TAGTGGAACTCATACA-1	aneuploid
TAGTGTCAGAAACGGC-1	aneuploid
TAGTTAAGATAGGATA-1	aneuploid
TAGTTTATTCTTGCTT-1	aneuploid
TAGTTTGATCGGTCGC-1	diploid
TATAAATCCACAAGCT-1	aneuploid
TATAAGTGAGGATAGC-1	aneuploid
TATACACAGACGCCTT-1	diploid
TATACACGCAAAGTAT-1	aneuploid
TATACCGAGTGCCACA-1	diploid
TATACGCGTCATCACT-1	diploid
TATACTCATGCGGCAA-1	aneuploid
TATAGATGGTCGCAGT-1	diploid
TATAGCGCACGTTATC-1	diploid
TATAGCTATTATCTCT-1	diploid
TATAGGGTACTCATGA-1	aneuploid
TATATAGGGCTTTACG-1	diploid
TATATATCGAGAAATG-1	diploid
TATATCAAAGTGATCT-1	diploid
TATATCATTGATCAGT-1	aneuploid
TATATCCCTGGGAGGA-1	diploid
TATATGCTGGGTTGCC-1	aneuploid
TATATTACAAATGTCG-1	diploid
TATATTCGCGTCGATA-1	diploid
TATCACAGCACGGGCA-1	diploid
TATCACCATGTAAAGT-1	aneuploid
TATCACCCAACCGACC-1	diploid
TATCACTTCGAGTAAC-1	aneuploid
TATCAGTGGCGTAGTC-1	diploid
TATCCATATCATGCGA-1	aneuploid
TATCCATCTCGGTTAG-1	diploid
TATCCGCACCGTCGGG-1	diploid
TATCCTATCAACTGGT-1	diploid
TATCCTGCATGGGAAT-1	aneuploid
TATCGATCTATGCATA-1	aneuploid
TATCGATGATTAAACG-1	aneuploid
TATCTACAGAGGTAAT-1	aneuploid
TATCTACCACAGCGGG-1	diploid
TATCTAGCCTAAAGGA-1	aneuploid
TATCTGAGCCGATATT-1	diploid
TATCTTGCAATACAAC-1	diploid
TATGAAGAATTAAGGT-1	diploid
TATGAAGACAGGTGCG-1	aneuploid
TATGACCTTGCGCTGG-1	aneuploid
TATGATAAATCTAACG-1	aneuploid
TATGATCCGGCACGCC-1	diploid
TATGATCTTCTCTTTA-1	diploid
TATGATTCTGCTTGGT-1	aneuploid
TATGCTCCCTACTTAC-1	aneuploid
TATGGAGTTTCTCGTT-1	aneuploid
TATGGATGTGCTACGC-1	aneuploid
TATGGCAGACTTTCGA-1	diploid
TATGGCCCGGCCTCGC-1	aneuploid
TATGGCTAGGCTAATT-1	diploid
TATGGGACCGAGCAGG-1	aneuploid
TATGGGTACGTATCGT-1	aneuploid
TATGGTCTGAGTAACA-1	aneuploid
TATGGTTAGTGGGAGA-1	diploid
TATGTAAAGTGCTTAA-1	diploid
TATGTAGAAACCCGGC-1	diploid
TATGTCAAGACCGACT-1	aneuploid
TATGTCTCATTGTGCC-1	diploid
TATTAACACCAAAGCA-1	diploid
TATTAACCTGACCGCG-1	diploid
TATTACCATCCTGCTT-1	diploid
TATTATGTTTGCCTGC-1	diploid
TATTCAATTCTAATCC-1	diploid
TATTCCACTCAGCTCG-1	diploid
TATTCCGAGCTGTTAT-1	diploid
TATTCCGGCAGTCCTA-1	aneuploid
TATTCCTCCGCCCACT-1	aneuploid
TATTCGTGCCAGAATA-1	aneuploid
TATTGACATTTCTGCC-1	diploid
TATTGCCGGGCTTGTA-1	diploid
TATTTAGTCTAGATCG-1	aneuploid
TATTTATACCGAGTAG-1	aneuploid
TATTTGATTTGCACAG-1	diploid
TATTTGTTACCCTTTA-1	aneuploid
TCAAACAACCGCGTCG-1	aneuploid
TCAAACAATTAGGACA-1	aneuploid
TCAAACTTAGATTGTT-1	aneuploid
TCAAAGAGCTATCTGT-1	diploid
TCAAATTGTTGTGCCG-1	diploid
TCAAATTTGAGACTCA-1	diploid
TCAACAAAGATAATTC-1	diploid
TCAACACATTGGGTAA-1	aneuploid
TCAACATAGCGCCCTA-1	diploid
TCAACATCGACCGAGA-1	aneuploid
TCAACCATGTTCGGGC-1	aneuploid
TCAACGCAGGAAATAA-1	aneuploid
TCAACGCGACCGGCAG-1	aneuploid
TCAACTAACGTATAAC-1	aneuploid
TCAACTGCAGAGTCAG-1	diploid
TCAAGAAATACTAGCT-1	diploid
TCAAGCGCGGACGGTA-1	diploid
TCAAGCTGCCTTGAAA-1	diploid
TCAAGGTTACTACACC-1	diploid
TCAATACAATTGCTGC-1	aneuploid
TCAATACGCCGTCATG-1	diploid
TCAATATACAGGAGGC-1	diploid
TCAATCCCGCGCCAAA-1	diploid
TCAATCCGGGAAGTTT-1	diploid
TCACAAACCGAGGTAC-1	diploid
TCACAGATCCTCAAAC-1	aneuploid
TCACAGCAAACTCGAA-1	diploid
TCACAGGAGAATAAGA-1	diploid
TCACAGGGAATCGCAA-1	diploid
TCACAGGTTATTGGGC-1	aneuploid
TCACATCTTATCTGAT-1	aneuploid
TCACCCTCTTAAGATT-1	diploid
TCACCGCTCGGCACTC-1	diploid
TCACGATGTCCGTGGA-1	diploid
TCACGATTAATACGTT-1	diploid
TCACGCATTGTAGATC-1	aneuploid
TCACGGCCCAAGAGAG-1	diploid
TCACGGTCATCGCACA-1	aneuploid
TCACTACGACCAATGC-1	aneuploid
TCACTATCCCTTCGGT-1	diploid
TCACTATCGTGCAATC-1	aneuploid
TCACTCAGCGCATTAG-1	aneuploid
TCACTCGTGCAACGGC-1	aneuploid
TCACTCTTCGTCTGTC-1	aneuploid
TCAGAACCTCCACAGG-1	diploid
TCAGAACGGCGGTAAT-1	diploid
TCAGACGCTATAGAAG-1	diploid
TCAGAGCATGTCAACG-1	diploid
TCAGAGGACGCGTTAG-1	diploid
TCAGATGGAGACGTAG-1	diploid
TCAGCAAATGCATCTC-1	diploid
TCAGCAGTAGGCCCTG-1	diploid
TCAGCCAATCCGTAAA-1	diploid
TCAGCGCACGCCGTTT-1	diploid
TCAGCTTGAGCTTTCG-1	diploid
TCAGGGCGACTTCCTT-1	aneuploid
TCAGGGCGCAAACTCG-1	aneuploid
TCAGGGTGCACGAAAC-1	aneuploid
TCAGGGTGTAACGTAA-1	aneuploid
TCAGGTTCTTTGAGAA-1	aneuploid
TCAGTACTGACCCGCG-1	aneuploid
TCAGTAGGGACTATAA-1	diploid
TCAGTGTATACGTCAT-1	diploid
TCAGTTACGGAATGAT-1	aneuploid
TCATACTTACAGATCC-1	aneuploid
TCATATGAGCTTTGTT-1	diploid
TCATCACTCGAGCTCG-1	aneuploid
TCATCCATCTGATCAC-1	diploid
TCATCCCAGAGGGTGG-1	aneuploid
TCATCCTCAGCTGCTT-1	diploid
TCATCGACGACCGTCG-1	diploid
TCATCGATGGTCCCAA-1	diploid
TCATGAAGCGCTGCAT-1	diploid
TCATGCAGGTTCTCAT-1	aneuploid
TCATTCGTATAATTTG-1	aneuploid
TCATTTAAGTCTCCGA-1	diploid
TCATTTAGAAGTGTGA-1	diploid
TCCAACTCAGCTATCT-1	diploid
TCCAACTTTAAATTCT-1	aneuploid
TCCAAGCCTAGACACA-1	diploid
TCCAATAAAGGCTACC-1	diploid
TCCAATGCGTCGCCGC-1	diploid
TCCACAATGGTTTACG-1	aneuploid
TCCACATCGTATATTG-1	diploid
TCCACCAAGACATAGG-1	diploid
TCCACTTTATCTAGGT-1	diploid
TCCAGAGCACCGGTTC-1	diploid
TCCAGATGTACGCCAA-1	diploid
TCCAGCGCTATAAGCG-1	diploid
TCCAGGCAGGACGATC-1	diploid
TCCAGGCGAGTACGGT-1	aneuploid
TCCAGGGTATATACGA-1	diploid
TCCATCAATACTAATC-1	diploid
TCCATTAGTTGGATAG-1	aneuploid
TCCATTCCCACTAGAG-1	diploid
TCCATTGTGACCTCGT-1	aneuploid
TCCCAAACAGACAACG-1	diploid
TCCCAAAGACGAAGGA-1	aneuploid
TCCCAAAGCCCTAAAT-1	diploid
TCCCACGGAGGGAGCT-1	aneuploid
TCCCACTCTCTTCCGG-1	diploid
TCCCAGCTTTAGTCTG-1	aneuploid
TCCCAGGCTTAGCTAA-1	aneuploid
TCCCGCCTATGTGCGT-1	diploid
TCCCGCGTACTCCTGG-1	aneuploid
TCCCGGGTGTGCTGCT-1	aneuploid
TCCCGGTCAGGAATTT-1	aneuploid
TCCCGTCAGTCCCGCA-1	aneuploid
TCCCGTCGCGTCATAG-1	diploid
TCCCGTGTGCAATTTG-1	diploid
TCCCTAGATCAATAGG-1	diploid
TCCCTCCGAAATCGTT-1	aneuploid
TCCCTCTTCTCAAGGG-1	diploid
TCCCTGGCGTATTAAC-1	diploid
TCCCTGGCTCGCTGGA-1	aneuploid
TCCCTTAGATTACTCG-1	aneuploid
TCCCTTGTCTGAAACT-1	diploid
TCCGAACGTTGCCGCT-1	diploid
TCCGAACTTGGCTTAC-1	aneuploid
TCCGAAGTAGTCACCA-1	aneuploid
TCCGAATGGTCCTGAG-1	diploid
TCCGACCGCTAATCAA-1	diploid
TCCGAGAAGGCTAAGC-1	aneuploid
TCCGATAATTGCCATA-1	aneuploid
TCCGATGACTGAGCTC-1	aneuploid
TCCGATGGTGCGACAT-1	aneuploid
TCCGATTACATTGCCG-1	aneuploid
TCCGCAGCCACCTAGC-1	aneuploid
TCCGCCTGTCTACAAG-1	diploid
TCCGCGGCCCAATGAA-1	diploid
TCCGCTGGGTCGATCG-1	diploid
TCCGCTGTCATCCCGG-1	diploid
TCCGCTTATCCCATTA-1	diploid
TCCGGAGGAAGGGCTG-1	aneuploid
TCCGGCCTAGCGTACA-1	diploid
TCCGGCCTGCATCGAT-1	aneuploid
TCCGGGCTTGACGGGA-1	diploid
TCCGGTTCGTCCGGTC-1	diploid
TCCGTAACCACAATCC-1	diploid
TCCGTTAAGCTAATAT-1	diploid
TCCGTTTAGCCTTGAA-1	diploid
TCCTAAAGATTCAGAC-1	diploid
TCCTAAATTGGGAAGC-1	diploid
TCCTAACCGTCGGGCA-1	diploid
TCCTACATCCACGGCC-1	diploid
TCCTAGCAAAGAAGCT-1	aneuploid
TCCTATCATAGGTAAC-1	diploid
TCCTCCTAAGACATTC-1	aneuploid
TCCTCGGGCTGGGCTT-1	diploid
TCCTCTACGAGATGGC-1	aneuploid
TCCTCTCCAGTTGTCC-1	aneuploid
TCCTCTGGCCCATTAG-1	aneuploid
TCCTGCAGCCGCCAAT-1	diploid
TCCTGCCAACTGGAGA-1	aneuploid
TCCTGCGTTGATACTC-1	aneuploid
TCCTGGCGCTGCCTGG-1	aneuploid
TCCTTACGACGGTCCG-1	diploid
TCCTTCAATCCCTACG-1	aneuploid
TCCTTCAGTGGTCGAA-1	aneuploid
TCCTTGTCCTTTAATT-1	diploid
TCCTTTAAATCCGCTT-1	diploid
TCCTTTCTTACGCTTA-1	aneuploid
TCGAAATTTAGGACCA-1	aneuploid
TCGAAGAACCGAGCAC-1	diploid
TCGAATATCCCGCAGG-1	diploid
TCGAATCGCAGGGTAG-1	diploid
TCGACAACTGAACCCG-1	diploid
TCGACATAGCGTAGCG-1	diploid
TCGAGACCAACACCGT-1	aneuploid
TCGAGCCAGGCAGGCC-1	diploid
TCGAGGGCAACAGACG-1	diploid
TCGAGTCTACGATTCG-1	diploid
TCGATAGGCTAGTCGC-1	aneuploid
TCGATGTTACGGCCGT-1	diploid
TCGATTTACGAAACGA-1	diploid
TCGCAAAGATGCATTT-1	diploid
TCGCACTAACGTTTGT-1	aneuploid
TCGCATAAAGGGCGCA-1	diploid
TCGCATCCCTAAGTGT-1	aneuploid
TCGCATTCAATGACTT-1	aneuploid
TCGCCACCCGGATTAC-1	diploid
TCGCCCAACTGACTCC-1	aneuploid
TCGCCCACTGCGAGAG-1	aneuploid
TCGCCGAAGTTGCGTC-1	aneuploid
TCGCCGACATATTCGC-1	diploid
TCGCCGCACCGCGTGA-1	diploid
TCGCCGGAGAGTCTTA-1	aneuploid
TCGCCGGTCGATCCGT-1	aneuploid
TCGCCTCCTTCGGCTC-1	diploid
TCGCCTCGACCTGTTG-1	aneuploid
TCGCGCGTTTACATGA-1	diploid
TCGCGTCCAGAAGGTC-1	aneuploid
TCGCTAAACCGCTATC-1	aneuploid
TCGCTACTGGCTTTGA-1	diploid
TCGCTCGATATATTCC-1	aneuploid
TCGCTCGGCACCAGCG-1	diploid
TCGCTGCCAATGCTGT-1	diploid
TCGCTGGGCGGATTGT-1	aneuploid
TCGCTGTGCGTAAATC-1	aneuploid
TCGCTTAATTACGAAG-1	aneuploid
TCGCTTTAAACGTTTG-1	aneuploid
TCGGAATGACCATCAA-1	aneuploid
TCGGAATGCGCTCTGA-1	aneuploid
TCGGAGAGTATCGGGA-1	aneuploid
TCGGAGTACATGAGTA-1	aneuploid
TCGGAGTCCTGGTTGC-1	diploid
TCGGATCTGGATGACC-1	diploid
TCGGCAGGGTTAAGGG-1	diploid
TCGGCGAACCCAAACC-1	diploid
TCGGCGGTATTAGATT-1	aneuploid
TCGGCGTACTGCACAA-1	diploid
TCGGCTAACTTCCCTT-1	aneuploid
TCGGCTTGTATCGACG-1	diploid
TCGGGAACGTGCCTAG-1	diploid
TCGGGATTCAAACATA-1	aneuploid
TCGGGCACTTCTGGAT-1	aneuploid
TCGGGCCGTCGTGGTA-1	diploid
TCGGGTGAAACTGCTA-1	aneuploid
TCGGTCCCGACAATAG-1	diploid
TCGGTCCCTGACTCCA-1	aneuploid
TCGGTGACCGCTCCGG-1	diploid
TCGGTTAGCCATGTAG-1	aneuploid
TCGTAACTCCCAAGAC-1	diploid
TCGTAAGACGACATTG-1	aneuploid
TCGTAAGCTCCGAGGA-1	aneuploid
TCGTACCGACGTCAAG-1	diploid
TCGTATAGTGCAATTA-1	aneuploid
TCGTATCACCAAGCTA-1	aneuploid
TCGTATTACCCATTGC-1	aneuploid
TCGTATTTCGTCCGGA-1	aneuploid
TCGTCAAGTACGCGCA-1	diploid
TCGTCACACTGTTAGC-1	aneuploid
TCGTCCGCTGGCGTCT-1	aneuploid
TCGTCCGGGTACACTC-1	aneuploid
TCGTCTTAGGCGTTAA-1	diploid
TCGTGTCACGCTGACA-1	diploid
TCGTGTTCGACCACAA-1	diploid
TCGTTAGGAGTCCCTA-1	diploid
TCGTTCGTTATTATGT-1	aneuploid
TCGTTGACAGGGTCCC-1	aneuploid
TCGTTGCTATCCGGTC-1	diploid
TCGTTGGCTCGTCAAT-1	aneuploid
TCGTTTACGCGACCCT-1	diploid
TCTAAAGAACAGTCTC-1	diploid
TCTAACTGTATGTAAA-1	aneuploid
TCTAATACTGCCTCAG-1	diploid
TCTACACGTTCATGCA-1	aneuploid
TCTACCCAATAGAGAG-1	diploid
TCTACCGTCCACAAGC-1	aneuploid
TCTACGCACGATCTCC-1	diploid
TCTACGGGCTCAGTTG-1	diploid
TCTAGCAATCTCCGCC-1	aneuploid
TCTAGCATCTTCGATG-1	aneuploid
TCTAGCATGCCCAGAA-1	diploid
TCTAGGTGGCGACGCT-1	diploid
TCTAGTGATATCGTGG-1	diploid
TCTAGTTATCAGAAGA-1	aneuploid
TCTATAGGTGGGTAAT-1	diploid
TCTATCATGCAGTTAC-1	aneuploid
TCTATCCGATTGCACA-1	diploid
TCTATCGGTCGCAACA-1	aneuploid
TCTATGCTATAACGAC-1	diploid
TCTATTACGCTGGCGA-1	aneuploid
TCTATTACTAGAGGAT-1	aneuploid
TCTCAAATCAATCGGG-1	diploid
TCTCAGGCTACTCGCT-1	diploid
TCTCATGAGATAGGGT-1	diploid
TCTCCAACGTAGGTTA-1	aneuploid
TCTCCACAAGTTGAAT-1	diploid
TCTCCCTGGGCAGCGT-1	diploid
TCTCGAACGAGGTCAC-1	diploid
TCTCGACGTATCGCCG-1	diploid
TCTCGAGGAGGTTCGC-1	diploid
TCTCGGCTCCAGGACT-1	aneuploid
TCTCGTGTTACGAGGA-1	aneuploid
TCTCTAATAGCTGGTA-1	aneuploid
TCTCTCGCCGCACATA-1	diploid
TCTCTTACCGCGAACC-1	diploid
TCTGAACCGGTCGGCT-1	aneuploid
TCTGAACTCGTACCCG-1	diploid
TCTGAAGCACGTGGTC-1	diploid
TCTGAATTCCGTACAA-1	diploid
TCTGACGGGCTAACCC-1	diploid
TCTGACTGTAATGGTT-1	aneuploid
TCTGAGCAATTGACTG-1	diploid
TCTGATCGGGTGCTAG-1	diploid
TCTGATTGGAAATGGA-1	diploid
TCTGCACCATTAGTAA-1	diploid
TCTGCAGATTCGAGTC-1	aneuploid
TCTGCATACCTTGCTT-1	diploid
TCTGCCAGAAACTGCA-1	diploid
TCTGCGAATCGTTCGC-1	diploid
TCTGCGTCCGGTTTCT-1	aneuploid
TCTGGAGCGTAAGAGT-1	diploid
TCTGGCCGTTCAAGTT-1	diploid
TCTGGCGCAAGCCGGG-1	aneuploid
TCTGGGAACCTTTGAA-1	diploid
TCTGGGTAGCGCTCAT-1	aneuploid
TCTGTCATACAAGAGC-1	aneuploid
TCTGTGACTGACCGTT-1	aneuploid
TCTGTGATGGAGGTTG-1	aneuploid
TCTGTGGCTACATTTC-1	aneuploid
TCTGTTACCCAGCATA-1	diploid
TCTTAACTCGGATGTA-1	aneuploid
TCTTACAGAGGTACCG-1	aneuploid
TCTTACCGGAACTCGT-1	aneuploid
TCTTACGGCATCCGAC-1	aneuploid
TCTTACTTATGCCTCT-1	diploid
TCTTAGAGCTCCAATT-1	diploid
TCTTAGAGTGAACTCT-1	diploid
TCTTATGGGTAGTACC-1	aneuploid
TCTTCCCATGGGCACA-1	diploid
TCTTCGAATAGACGTT-1	diploid
TCTTCGATACCAATAA-1	aneuploid
TCTTCGCGGTGAGAGG-1	diploid
TCTTCTATAACCCGCC-1	diploid
TCTTGATGCGTAGCGA-1	aneuploid
TCTTGCTCCCGATACT-1	diploid
TCTTGGTAACACCAAA-1	aneuploid
TCTTGGTCAATGATAC-1	diploid
TCTTTAAGACTATGAA-1	diploid
TCTTTAGAGTCTAACA-1	diploid
TCTTTAGCAGGCGAAC-1	diploid
TCTTTCATCCGTCCTT-1	diploid
TCTTTCCTTCGAGATA-1	diploid
TCTTTCGGCGGGACAC-1	aneuploid
TCTTTCTCTTAAGGAG-1	aneuploid
TGAAACCTCAACTCAC-1	aneuploid
TGAAACTTATGCAAGC-1	aneuploid
TGAACACCCGAAGCAG-1	aneuploid
TGAACCTGAATGTGAG-1	diploid
TGAACTGCTATGACTT-1	aneuploid
TGAAGAGCGGTCCTAG-1	aneuploid
TGAAGTAGCTTACGGA-1	aneuploid
TGAATACCGACGCGTA-1	diploid
TGAATATGCTATAAAC-1	diploid
TGAATGAGATACAGCA-1	diploid
TGAATGAGTGTTTCCC-1	diploid
TGAATGTCAGCCGGCC-1	diploid
TGAATTTCACTTGCCT-1	aneuploid
TGACAACGCATGTCGC-1	diploid
TGACACTTCTCTTTGC-1	aneuploid
TGACAGAAATCTTGCT-1	diploid
TGACAGGACAAGTCCA-1	diploid
TGACATATATGACGAT-1	aneuploid
TGACATCGAGCGGACC-1	diploid
TGACATGTAACGTGAC-1	diploid
TGACCAAATCTTAAAC-1	diploid
TGACCAGCTTCAAAGT-1	aneuploid
TGACCCAACTCACATT-1	aneuploid
TGACCCACGTTAGACA-1	aneuploid
TGACCCAGCATTCCCG-1	aneuploid
TGACGAATATTTCCCT-1	aneuploid
TGACGATGCACTAGAA-1	diploid
TGACTATAATCCTTTC-1	diploid
TGACTCCGAATCATAC-1	diploid
TGAGAATGCTTTACCG-1	aneuploid
TGAGACGTACCTCTCA-1	aneuploid
TGAGAGATTTACCACG-1	diploid
TGAGATCAAATACTCA-1	aneuploid
TGAGATTAGGCCCTAA-1	aneuploid
TGAGCAGTCGTGAAGT-1	aneuploid
TGAGCCATACAGTCTC-1	aneuploid
TGAGCTTTAATGACGC-1	aneuploid
TGAGGCATGTACTGTG-1	diploid
TGAGGTGTGTGGCGGA-1	diploid
TGAGGTTGATCCCAAG-1	aneuploid
TGAGTAAATTAGCGTA-1	diploid
TGAGTGCCTCTTAAAT-1	diploid
TGAGTGGTCCGTGACG-1	diploid
TGAGTGTAACAACGGG-1	diploid
TGAGTTAAAGACATTC-1	diploid
TGATACATTTAGCCGT-1	diploid
TGATAGCGGGATTCTA-1	aneuploid
TGATCACCACACTGAC-1	diploid
TGATCAGGGAACTGCT-1	aneuploid
TGATCCCAGCATTAGT-1	diploid
TGATCGGTTTGACCCT-1	aneuploid
TGATCTACGCTGATCT-1	aneuploid
TGATCTATCACACTCT-1	diploid
TGATCTCCGGCGCCAG-1	aneuploid
TGATGCTCACGTAGTC-1	aneuploid
TGATGGCTGTTTCTGA-1	diploid
TGATGGGACTAAGTCA-1	aneuploid
TGATGTCAATTAAGTG-1	diploid
TGATTATGGCACGCAG-1	aneuploid
TGATTCAGGTCCCGCG-1	diploid
TGATTCCCGGTTACCT-1	diploid
TGATTCGTCTATCACT-1	aneuploid
TGATTCTGTCGCCGGT-1	diploid
TGATTTATTAGCTGTG-1	aneuploid
TGATTTCCTCCTGACG-1	aneuploid
TGCAAACCCACATCAA-1	aneuploid
TGCAAAGTTCGTCTGT-1	diploid
TGCAACCCATCTGCGG-1	diploid
TGCAACTACTGGTTGA-1	diploid
TGCAAGAATGACGTAA-1	aneuploid
TGCAATCTAACACGGT-1	diploid
TGCAATTTGGGCACGG-1	diploid
TGCACAGTGAAGTTAT-1	aneuploid
TGCACGAGTCGGCAGC-1	aneuploid
TGCACTATGTGAGTGC-1	aneuploid
TGCAGAGTACCGAGCA-1	aneuploid
TGCAGATCGTCCTAGG-1	aneuploid
TGCAGCTACGTACTTC-1	aneuploid
TGCAGGATCGGCAAAG-1	aneuploid
TGCAGTGAGGCTCGGG-1	diploid
TGCAGTGGTAGGGAAC-1	diploid
TGCAGTTTCCTCCCAT-1	diploid
TGCATATGTCTGTCAC-1	diploid
TGCATCTCCGGATCTT-1	aneuploid
TGCATGAGTAGATTCG-1	aneuploid
TGCATGGATCGGATCT-1	aneuploid
TGCATGGCAGTCTTGC-1	aneuploid
TGCATGTGACCCATAG-1	diploid
TGCATGTGGTAATCTA-1	diploid
TGCCAAAGTCAGACTT-1	aneuploid
TGCCAATGGGTACTCT-1	diploid
TGCCACACTAGAGGAA-1	aneuploid
TGCCACCTGGCGAAAC-1	aneuploid
TGCCAGTACGTGGAGA-1	diploid
TGCCATGGCTTATAAG-1	aneuploid
TGCCATTACTAAAGAA-1	aneuploid
TGCCCGATAGTTAGAA-1	diploid
TGCCCGTACCGTTAAA-1	diploid
TGCCGAAAGCGTATTC-1	diploid
TGCCGATGTCATCAAT-1	aneuploid
TGCCGGATGTACGAGC-1	diploid
TGCCGTGGGACCCAAT-1	diploid
TGCCGTTCTTAATCGG-1	diploid
TGCCTAATTGAAGATT-1	diploid
TGCCTGACATCGGTCA-1	aneuploid
TGCCTGATCAAACGAT-1	aneuploid
TGCCTTGCCCTTACGG-1	aneuploid
TGCCTTGGCCAGGCAA-1	diploid
TGCGAATATGGGATTT-1	aneuploid
TGCGACACCCTAGTGC-1	diploid
TGCGACGGCCGAACGT-1	diploid
TGCGAGAAACGTTACG-1	aneuploid
TGCGAGAATATTACCC-1	diploid
TGCGAGATGGCGGCCA-1	aneuploid
TGCGAGCCCTTCCGCG-1	aneuploid
TGCGATGCTAATGGCT-1	aneuploid
TGCGCAAAGCATTTGG-1	aneuploid
TGCGCCGTTAATAACG-1	diploid
TGCGCGATTAACGGAG-1	aneuploid
TGCGGACTTGACTCCG-1	diploid
TGCGGAGTAAAGGTGC-1	aneuploid
TGCGGCATAGTTCAAC-1	aneuploid
TGCGGGTATTGGGATC-1	aneuploid
TGCGGTCTACGAGTAA-1	aneuploid
TGCGGTGAAATTTCAT-1	aneuploid
TGCGTAAGAACCTGAT-1	diploid
TGCGTACGGCTAATTG-1	diploid
TGCGTCATGACTGAGC-1	diploid
TGCGTGATTGGGTGTC-1	aneuploid
TGCGTTTGTTGACACT-1	diploid
TGCTAAGTGTCTATTT-1	diploid
TGCTATACAAACGGAC-1	aneuploid
TGCTATGGCAAAGGGA-1	diploid
TGCTCAAAGGATGCAC-1	diploid
TGCTCACACAACAACC-1	aneuploid
TGCTCCACAGTTCTTA-1	diploid
TGCTCGGTGGGTCACC-1	diploid
TGCTCTGCCGGTTCAC-1	diploid
TGCTCTTGAGAGTTTG-1	diploid
TGCTGCGTCAGAGTTA-1	aneuploid
TGCTGGTTGGACAATT-1	aneuploid
TGCTGTTGAAGAACTC-1	diploid
TGCTTAGAGAGAATGC-1	diploid
TGCTTCCCAAGCAGTA-1	diploid
TGCTTGAAACCATGCA-1	aneuploid
TGGAAACGGAGTGAAC-1	aneuploid
TGGAACCACTGACACA-1	diploid
TGGAAGAAGGGAACGT-1	aneuploid
TGGAAGACGAACACCA-1	aneuploid
TGGAAGGATAAAGATG-1	aneuploid
TGGAATATCCTTGACC-1	diploid
TGGAATTAGACGCTTT-1	aneuploid
TGGACACCGTTGCTTG-1	aneuploid
TGGACCAATCTAAGAT-1	diploid
TGGACCACGGCGTTGA-1	aneuploid
TGGACGCAATCCAGCC-1	diploid
TGGACGTAGGCGAATC-1	aneuploid
TGGACTGTTCGCTCAA-1	diploid
TGGAGAATAATCGTCC-1	diploid
TGGAGCTAAAGTTCCC-1	aneuploid
TGGAGGGAAACACCTC-1	diploid
TGGAGTGATGCGATGA-1	aneuploid
TGGATAGAGTAACAGA-1	aneuploid
TGGCAAACTAAATTAC-1	diploid
TGGCAACTCGCGCGCC-1	aneuploid
TGGCAAGCACAAGTCG-1	diploid
TGGCAATGGGACGGCG-1	diploid
TGGCACGAGCTCGAGT-1	aneuploid
TGGCAGATTACGATCA-1	diploid
TGGCATGAAGTTTGGG-1	diploid
TGGCCAAACTGAAGTA-1	diploid
TGGCCAATTTGGTACT-1	diploid
TGGCCGTATATTGACC-1	aneuploid
TGGCGACTGCTCCAAA-1	diploid
TGGCGATCAAGTTATG-1	diploid
TGGCGGTGTGCGATTG-1	aneuploid
TGGCTACACTCTACCT-1	diploid
TGGCTATGTGACATAC-1	diploid
TGGCTCTTGTCGCGTA-1	aneuploid
TGGCTTATGTATAATG-1	diploid
TGGCTTGTACAAGCTT-1	diploid
TGGCTTTGGGTAGACA-1	aneuploid
TGGGAAATGCCTTTCC-1	aneuploid
TGGGACCATTGGGAGT-1	aneuploid
TGGGATGCACTCATTC-1	aneuploid
TGGGCAATAGTTGGGT-1	diploid
TGGGCACAAACAGAAC-1	aneuploid
TGGGCACGTTCTATGG-1	aneuploid
TGGGCAGGCCACCGCA-1	diploid
TGGGCCACAAGAGCGC-1	aneuploid
TGGGCCCATACTAATT-1	diploid
TGGGCCTTGCCTGCAT-1	aneuploid
TGGGCGATACAATAAG-1	diploid
TGGGTAAGGTTCCCGC-1	aneuploid
TGGGTGCACAAGCCAT-1	diploid
TGGGTGGGATGTCATT-1	aneuploid
TGGGTGTAATAGATTT-1	diploid
TGGGTGTTAAGTAGAA-1	diploid
TGGGTTCCCGGACGGA-1	aneuploid
TGGGTTTCGGGCGTAC-1	diploid
TGGTAAGCAGGATTGA-1	aneuploid
TGGTACCGGCACAGCC-1	aneuploid
TGGTAGAATATATGGG-1	diploid
TGGTATCGCATCCCAA-1	aneuploid
TGGTATCGGTCTGTAT-1	diploid
TGGTCCCACGCTACGG-1	diploid
TGGTCGATATACCTCT-1	diploid
TGGTCGGGTACAGGGC-1	diploid
TGGTCGTGCAAGGCAA-1	aneuploid
TGGTCGTTTGATAGAT-1	aneuploid
TGGTCTAGCTTACATG-1	aneuploid
TGGTCTGTTGGGCGTA-1	aneuploid
TGGTGATCGTATTTGT-1	aneuploid
TGGTGCCCTGCCTTAC-1	diploid
TGGTGTGACAGACGAT-1	aneuploid
TGGTTAACTTACATTT-1	diploid
TGGTTAAGGGCGCTGG-1	diploid
TGGTTCAACGGGTAAT-1	diploid
TGGTTCGTAGCAAAGG-1	aneuploid
TGGTTGGAGGATCCTG-1	aneuploid
TGGTTTAAACGTGGGT-1	diploid
TGTAACTTGTCAACCT-1	aneuploid
TGTAAGACTGATAAGA-1	diploid
TGTAATGACCACAATA-1	aneuploid
TGTAATGCCTTCGGAC-1	aneuploid
TGTACCCGACCCTAAT-1	diploid
TGTACCTACACGAGGG-1	diploid
TGTACGAACAAATCCG-1	diploid
TGTACGCTATCAGCTT-1	aneuploid
TGTACTACTCTCACGG-1	diploid
TGTACTGTGCCAAAGT-1	aneuploid
TGTACTTCCGGGCATG-1	diploid
TGTAGCCAATTCCGTT-1	diploid
TGTAGCCATCCCATTC-1	diploid
TGTAGGAGAAATTTCC-1	diploid
TGTAGTGATCTATAAT-1	aneuploid
TGTATAACAGATCCTG-1	diploid
TGTATACGGATGATGA-1	diploid
TGTATCAGACTGAAGC-1	aneuploid
TGTATCCTTATTCCAT-1	aneuploid
TGTATGGCGCAGACAG-1	diploid
TGTATTTACCTAATGC-1	aneuploid
TGTCATTTGTTGGGAA-1	diploid
TGTCCACGGCTCAACT-1	diploid
TGTCCCGACATAGCAC-1	diploid
TGTCCGCAAACAATTC-1	diploid
TGTCCGTGGCGCCTTT-1	aneuploid
TGTCCTAAGTCACCGC-1	aneuploid
TGTCGGCATGGTGGAA-1	aneuploid
TGTCGTGGGTATAGGC-1	diploid
TGTCGTTATCACATAT-1	diploid
TGTCTACAGTTTCTGT-1	aneuploid
TGTGACTACGCCAGTC-1	aneuploid
TGTGACTAGAGTTTGC-1	diploid
TGTGAGACTAGCCCAA-1	diploid
TGTGATTCCAGCGCTT-1	aneuploid
TGTGCCAGAGGCAAAG-1	diploid
TGTGCCGGTGCCGGAA-1	diploid
TGTGCTTTACGTAAGA-1	aneuploid
TGTGGCAAAGCGTATG-1	diploid
TGTGGCGGGCTTCTGG-1	diploid
TGTGGCTCCCACCAAC-1	diploid
TGTGGTTGCTAAAGCT-1	diploid
TGTGTAGTAGCACGTG-1	diploid
TGTGTCGAAGTCGAGG-1	aneuploid
TGTGTCGCGAGTTGCA-1	aneuploid
TGTGTGACCATGAATC-1	aneuploid
TGTGTTCGTATCCAAG-1	aneuploid
TGTTAACAAAGTGACT-1	diploid
TGTTATTGTATGTGGC-1	diploid
TGTTCATAAATGTGCT-1	aneuploid
TGTTCCGCTTCCATGA-1	aneuploid
TGTTCCGGCCTGAGCT-1	diploid
TGTTCGTATTGCGGTG-1	diploid
TGTTCTCTACTCCCTA-1	diploid
TGTTCTTCCATTGACT-1	aneuploid
TGTTGATCACTGTTTA-1	aneuploid
TGTTGCCGTCGTCCCA-1	diploid
TGTTGGCTGGCGGAAG-1	aneuploid
TGTTGTCAAGAAGTCT-1	aneuploid
TGTTTAATACTTCATC-1	aneuploid
TGTTTCGGTACTTCTC-1	aneuploid
TGTTTCTGAAGCGTGC-1	diploid
TTAAACAGAGTCCCGC-1	aneuploid
TTAAACCGGTAGCGAC-1	aneuploid
TTAAACCTGGTTCCTT-1	aneuploid
TTAAACTCGAATTCAT-1	diploid
TTAAAGGCGATGCTCG-1	diploid
TTAAAGTAAGTCGCCA-1	diploid
TTAACACCTCGAACAT-1	aneuploid
TTAACCAACCCTCCCT-1	aneuploid
TTAACCCGAGGCGTGT-1	diploid
TTAACGAACAAGCAGT-1	diploid
TTAACGTCGCAAGACC-1	aneuploid
TTAACTCACGCGTGGA-1	aneuploid
TTAACTTCAGGTAGGA-1	aneuploid
TTAAGACGAACGAACC-1	aneuploid
TTAAGATACCCAGAGA-1	diploid
TTAAGATAGGATTGAC-1	diploid
TTAAGCCGACAACTTC-1	aneuploid
TTAAGCGCCTGACCCA-1	aneuploid
TTAAGGATACGGAGGT-1	aneuploid
TTAAGGCCCGTACTTT-1	diploid
TTAAGTATTGTTATCC-1	diploid
TTAATCAGTACGTCAG-1	aneuploid
TTAATGCGAGGTAACT-1	diploid
TTAATGTAGACCAGGT-1	aneuploid
TTAATGTGTTTGCAGG-1	aneuploid
TTAATTGCTTTGGGTG-1	diploid
TTAATTTCAGACGCGG-1	aneuploid
TTACAACTACGCATCC-1	aneuploid
TTACACGATCTGCGAC-1	diploid
TTACAGACCTAAATGA-1	diploid
TTACATCGTGGCCTGG-1	aneuploid
TTACATGCCACAACTA-1	diploid
TTACCATTGATTACCC-1	aneuploid
TTACCCATTGCCGGGT-1	aneuploid
TTACCCTAACAGTCCT-1	aneuploid
TTACCCTAGGGATTGG-1	diploid
TTACCGCCTTAGGGAA-1	aneuploid
TTACGGATGGTTCGAG-1	diploid
TTACGGTGTCACCGAG-1	aneuploid
TTACGTAGCGCGTGCT-1	aneuploid
TTACGTATCTATGACA-1	diploid
TTACTAAAGGACTTTA-1	diploid
TTACTATCGGCTTCTC-1	aneuploid
TTACTCTGGTACGTAC-1	aneuploid
TTACTGGGATATTTCA-1	diploid
TTACTGTCTAGAGCTC-1	diploid
TTACTGTTTCTCTACG-1	aneuploid
TTAGAAGAACATGACT-1	diploid
TTAGAATAAGGGTCGG-1	diploid
TTAGACACGATCGTTG-1	aneuploid
TTAGACGAGTCACCTC-1	diploid
TTAGAGGGATATACAG-1	diploid
TTAGAGTATTGTCGAG-1	diploid
TTAGAGTTTAGAAGGA-1	diploid
TTAGATAGGTCGATAC-1	aneuploid
TTAGCAACATGGATGT-1	aneuploid
TTAGCATCCCTCACGT-1	diploid
TTAGCCATAGGGCTCG-1	diploid
TTAGCTAATACGATCT-1	diploid
TTAGCTCTGTAATCCG-1	aneuploid
TTAGCTGATTTGCCGT-1	diploid
TTAGGTCATAACCGAC-1	diploid
TTAGGTGTGACTGGTC-1	aneuploid
TTAGTAAACCTGCTCT-1	diploid
TTAGTAGGGCGGCGGG-1	aneuploid
TTAGTTATTCGTGGCA-1	diploid
TTAGTTCAAGTGTTCG-1	diploid
TTATAGATGCACATTA-1	aneuploid
TTATAGGTAATTGTCT-1	diploid
TTATAGTCCAAGGTGC-1	aneuploid
TTATATACGCTGTCAC-1	diploid
TTATATTTGGCAATCC-1	aneuploid
TTATCATACTCGCAAA-1	diploid
TTATCCAATCGAACTC-1	aneuploid
TTATCCGGGATCTATA-1	diploid
TTATCCTCAAGGAATA-1	diploid
TTATCGCCTGCGAAGC-1	aneuploid
TTATCTGACATTAGGA-1	diploid
TTATCTGTATCATAAC-1	aneuploid
TTATGAATGAAAGGGA-1	diploid
TTATGACAAACTGGAT-1	aneuploid
TTATGATCTTAACGAA-1	diploid
TTATGCGTCCCGGTCC-1	aneuploid
TTATGTTTGCGATAGA-1	aneuploid
TTATTAGAGCGTGTTC-1	diploid
TTATTAGGGAAGCATC-1	aneuploid
TTATTATCTGGAAGGC-1	diploid
TTATTTCATCCCAAAC-1	aneuploid
TTCAACGACCCGACCG-1	aneuploid
TTCAAGCCGAGCTGAG-1	aneuploid
TTCAATACTCTGAATC-1	diploid
TTCAATTAGCCATAAT-1	aneuploid
TTCACGAAAGGATCAC-1	diploid
TTCACGGTCGTCACGT-1	diploid
TTCACTTCCTAGAACG-1	diploid
TTCAGAGTAACCTGAC-1	aneuploid
TTCAGCCCTGGTCCAC-1	diploid
TTCAGCTGGCGTGCCC-1	diploid
TTCAGGCGTCAAAGCC-1	aneuploid
TTCAGTTCAAGAGGAG-1	diploid
TTCAGTTTGTGGCAGC-1	aneuploid
TTCATAGCCTTGTAAC-1	aneuploid
TTCATAGGGTGTCCAT-1	aneuploid
TTCATGGCGCAACAGG-1	aneuploid
TTCCAATCAGAGCTAG-1	aneuploid
TTCCAATCTGGCTATC-1	diploid
TTCCACACAGATTTGA-1	diploid
TTCCACATTTCTCGTC-1	aneuploid
TTCCAGACGAGATTTA-1	diploid
TTCCAGTGGGTTTCGT-1	diploid
TTCCATCATGCGGTGA-1	aneuploid
TTCCATCGACAGCGTG-1	diploid
TTCCCGACGCTTCACT-1	aneuploid
TTCCCGGCGCCAATAG-1	aneuploid
TTCCGCAGAGAAATAT-1	diploid
TTCCGCGTGAGGCGAT-1	diploid
TTCCGGCCTTGAGGCT-1	diploid
TTCCGGCTCGACTTCT-1	aneuploid
TTCCGGTATCTGTGTC-1	diploid
TTCCGGTTACCCACTT-1	diploid
TTCCTCGAGGGTGTCT-1	aneuploid
TTCCTCGGACTAACCA-1	diploid
TTCCTCTGCCCGAATA-1	aneuploid
TTCCTTTCTGTGTTGC-1	aneuploid
TTCGAACGAAACATGC-1	diploid
TTCGACAGAGCCCGTG-1	diploid
TTCGACGGGAAGGGCG-1	aneuploid
TTCGAGCCGGCGCTAC-1	aneuploid
TTCGCACTCGCGTGCT-1	aneuploid
TTCGCACTGTACGACA-1	diploid
TTCGCATCCGGAAGCA-1	aneuploid
TTCGCCGCTCGCGCTA-1	diploid
TTCGCGCGCCATACGA-1	diploid
TTCGCTAGGAAGTTGT-1	diploid
TTCGCTATCTGACGTG-1	aneuploid
TTCGGACTGATGCCTT-1	aneuploid
TTCGGACTGGGCATGG-1	diploid
TTCGGCAACCCGCTGA-1	aneuploid
TTCGGCTAGAGATGGT-1	aneuploid
TTCGGGCGCTAGTCTT-1	diploid
TTCGGGTTGCCACGGG-1	diploid
TTCGGTACTGTAGAGG-1	diploid
TTCGGTGGAGACGCCC-1	diploid
TTCGTAATCCCAGCGG-1	aneuploid
TTCGTACTCCAGAACG-1	aneuploid
TTCGTGGGCTGGAAGC-1	aneuploid
TTCGTTCAACGAAGTT-1	diploid
TTCTAACCGAAGCTTA-1	diploid
TTCTACCTTTATGTTG-1	aneuploid
TTCTACTTGCGAGGGC-1	aneuploid
TTCTAGAAAGTCTTAT-1	diploid
TTCTAGGCCAATTGTG-1	aneuploid
TTCTATGCCTTTCGCA-1	diploid
TTCTATTAAACGCAGC-1	diploid
TTCTCTTACAGGTGAT-1	diploid
TTCTGACCGGGCTCAA-1	diploid
TTCTGCCGCGCCTAGA-1	diploid
TTCTGCGAGCGCCCTT-1	aneuploid
TTCTGCGGGTTAGCGG-1	diploid
TTCTGCTAGACTCCAA-1	diploid
TTCTGTTTCCTGTCGC-1	aneuploid
TTCTTAGTGAACGGTG-1	aneuploid
TTCTTAGTGGCTCAGA-1	aneuploid
TTCTTATCCGCTGGGT-1	diploid
TTCTTCCCTTTGATAT-1	aneuploid
TTCTTCGCAATAGAGC-1	aneuploid
TTCTTGAGCCGCGCTA-1	diploid
TTCTTGCTAGCATCTC-1	diploid
TTCTTGGACGATCTGC-1	diploid
TTCTTGGAGTAATGAG-1	aneuploid
TTCTTGTAACCTAATG-1	aneuploid
TTCTTGTGTCCATCAG-1	aneuploid
TTCTTTGGTCGCGACG-1	diploid
TTGAAACCCTCATTCC-1	diploid
TTGAAAGGTGTAAAGG-1	aneuploid
TTGAACGAATCCTTTG-1	aneuploid
TTGAACGACGTGCTGA-1	diploid
TTGAAGAATTCCCAGG-1	aneuploid
TTGAAGGATGGGCGCC-1	diploid
TTGAATCGTTGTATAA-1	diploid
TTGAATTCACGTGAGG-1	diploid
TTGACAGGAGCTCCCG-1	diploid
TTGACATGAACGTGGA-1	aneuploid
TTGACCAGGAACAACT-1	diploid
TTGACCATGTTCTCCG-1	aneuploid
TTGACCGTGTTAATGA-1	diploid
TTGACGATTCAGCACG-1	aneuploid
TTGACGCTCCATGAGC-1	diploid
TTGACTACCATATGGT-1	diploid
TTGACTATTGTCCGGC-1	diploid
TTGAGAAGTTTAGCAT-1	diploid
TTGAGAGTACTGCTAA-1	aneuploid
TTGAGCAGCCCACGGT-1	diploid
TTGAGCGCCACGTGAT-1	diploid
TTGAGGCATTTAACTC-1	aneuploid
TTGAGGGTCGAACGCG-1	aneuploid
TTGAGTCCCGCTGCTG-1	diploid
TTGATAGTCAATACAT-1	diploid
TTGATCTAACTTTGTC-1	aneuploid
TTGATGCCGCTCGTCG-1	diploid
TTGATGTGTAGTCCCG-1	aneuploid
TTGATTAGCTGTTTCT-1	aneuploid
TTGATTATGCAGATGA-1	aneuploid
TTGCAAGAAGACTCCT-1	diploid
TTGCACAATTCAGAAA-1	diploid
TTGCACGGAGCAGCAC-1	aneuploid
TTGCAGGTCATGAAGT-1	aneuploid
TTGCATGCTGATCACG-1	aneuploid
TTGCCAAGCAGAACCC-1	diploid
TTGCCATAGCCCGCTC-1	diploid
TTGCCCTGATCACGGG-1	aneuploid
TTGCCGCAGACCTACA-1	diploid
TTGCCGCTTTCTAGTA-1	diploid
TTGCCGGTGATCCCTC-1	aneuploid
TTGCCTAATCCAAAGT-1	diploid
TTGCCTTCTCGCCGGG-1	diploid
TTGCGCTCTCTCGCTT-1	aneuploid
TTGCGCTTGATCAATA-1	diploid
TTGCGGCATCAGAAAG-1	diploid
TTGCGGCGACTCATGC-1	aneuploid
TTGCGTAGTTTGAGGA-1	aneuploid
TTGCGTGAACGCTTAG-1	aneuploid
TTGCGTGTGTAGGCAT-1	diploid
TTGCTAGCTACCAATC-1	aneuploid
TTGCTCATAGTACGTG-1	diploid
TTGCTCCCATACCGGA-1	aneuploid
TTGCTGAAGGAACCAC-1	aneuploid
TTGCTGATCATGTTCG-1	aneuploid
TTGCTGCACCTATCCA-1	aneuploid
TTGCTGGCCGGGCTTC-1	aneuploid
TTGGAAGAATACAGTC-1	diploid
TTGGACATGTGGCTTA-1	aneuploid
TTGGACCATCTGGCAA-1	diploid
TTGGACCTATAACAGT-1	diploid
TTGGAGTCTCCCTTCT-1	aneuploid
TTGGATATCGTCTACG-1	diploid
TTGGATCGACTTCTGG-1	aneuploid
TTGGATTGGGTACCAC-1	aneuploid
TTGGCCAAATTGTATC-1	diploid
TTGGCCATCTTGCGCT-1	aneuploid
TTGGCCTAGAATTTCG-1	aneuploid
TTGGCGATCCGAATAT-1	diploid
TTGGCTCAATATGTGT-1	diploid
TTGGCTCGCATGAGAC-1	aneuploid
TTGGGAAGACGAGCCG-1	diploid
TTGGGACACTGCCCGC-1	aneuploid
TTGGGACGTAAGAGTT-1	diploid
TTGGGCGGCGGTTGCC-1	diploid
TTGGGTTTATTCAGCG-1	diploid
TTGGTATGGCTTGTGT-1	diploid
TTGGTCACACTCGTAA-1	diploid
TTGGTGCGGTGTTGAA-1	aneuploid
TTGGTTCGCTCAAAGG-1	diploid
TTGGTTGCGGTGCGCG-1	diploid
TTGTAACTTCATAGCG-1	aneuploid
TTGTAAGGACCTAAGT-1	aneuploid
TTGTAAGGCCAGTTGG-1	diploid
TTGTAATCCGTACTCG-1	aneuploid
TTGTACACCTCGAACA-1	diploid
TTGTATCACACAGAAT-1	aneuploid
TTGTCACCGCGGTATC-1	diploid
TTGTCGTTCAGTTACC-1	aneuploid
TTGTCTCGGCAAGATG-1	diploid
TTGTGAACCTAATCCG-1	diploid
TTGTGAGGCATGACGC-1	aneuploid
TTGTGATCTGTTCAGT-1	diploid
TTGTGCAGCCACGTCA-1	diploid
TTGTGCGGAAGCGGAT-1	diploid
TTGTGGAGACAGCCGG-1	diploid
TTGTGGCCCTGACAGT-1	aneuploid
TTGTGGTAGGAGGGAT-1	diploid
TTGTGGTATAGGTATG-1	diploid
TTGTGGTGGTACTAAG-1	diploid
TTGTGTATGCCACCAA-1	diploid
TTGTGTTTCCCGAAAG-1	diploid
TTGTTAGCAAATTCGA-1	aneuploid
TTGTTCAGTGTGCTAC-1	aneuploid
TTGTTCTAGATACGCT-1	aneuploid
TTGTTGGCAATGACTG-1	diploid
TTGTTGTGTGTCAAGA-1	diploid
TTGTTTCACATCCAGG-1	diploid
TTGTTTCATTAGTCTA-1	diploid
TTGTTTCCATACAACT-1	aneuploid
TTGTTTGTATTACACG-1	diploid
TTGTTTGTGTAAATTC-1	aneuploid
AAGAGGATGTACGCGA-1	not.defined
AAGGAGAACTTATAAG-1	not.defined
AATCTCTACTGTGGTT-1	not.defined
ACTGTTTAGTGTAGGC-1	not.defined
AGAAGAGCGCCGTTCC-1	not.defined
ATGGTGCTCAAAGCCA-1	not.defined
ATGTGTAGTTTAGTCA-1	not.defined
CCCTCGGGAGCCTTGT-1	not.defined
CCTAAACAGGGTCCGT-1	not.defined
GACGGACCGCGTTCCT-1	not.defined
GACGTGTAGGGATTAT-1	not.defined
GCAGATCCTCGCAAAT-1	not.defined
GCATCGGCCGTGTAGG-1	not.defined
GCGTGTATGTCGTATT-1	not.defined
GGAATAACCTCAAGAA-1	not.defined
TATAGAGTCGCTTGAA-1	not.defined
TCGTGTATTGGTCACG-1	not.defined
TGTGGAGGAAGCTTAA-1	not.defined
