cell.names	copykat.pred
AAACAAGTATCTCCCA-1	c2:aneuploid:low.conf
AAACAATCTACTAGCA-1	c2:aneuploid:low.conf
AAACAGAGCGACTCCT-1	c2:aneuploid:low.conf
AAACAGTGTTCCTGGG-1	c2:aneuploid:low.conf
AAACATTTCCCGGATT-1	c1:diploid:low.conf
AAACCCGAACGAAATC-1	c2:aneuploid:low.conf
AAACCGTTCGTCCAGG-1	c2:aneuploid:low.conf
AAACCTAAGCAGCCGG-1	c2:aneuploid:low.conf
AAACGAAGAACATACC-1	c2:aneuploid:low.conf
AAACGAGACGGTTGAT-1	c1:diploid:low.conf
AAACGCCCGAGATCGG-1	c2:aneuploid:low.conf
AAACGGGCGTACGGGT-1	c1:diploid:low.conf
AAACGGTTGCGAACTG-1	c2:aneuploid:low.conf
AAACGTGTTCGCCCTA-1	c2:aneuploid:low.conf
AAACTAACGTGGCGAC-1	c2:aneuploid:low.conf
AAACTCGGTTCGCAAT-1	c2:aneuploid:low.conf
AAACTCGTGATATAAG-1	c2:aneuploid:low.conf
AAACTGCTGGCTCCAA-1	c2:aneuploid:low.conf
AAAGAATGTGGACTAA-1	c1:diploid:low.conf
AAAGACCCAAGTCGCG-1	c2:aneuploid:low.conf
AAAGCTTGCCTACATA-1	c2:aneuploid:low.conf
AAAGGCCCTATAATAC-1	c1:diploid:low.conf
AAAGGCTACGGACCAT-1	c2:aneuploid:low.conf
AAAGGCTCTCGCGCCG-1	c2:aneuploid:low.conf
AAAGGGATGTAGCAAG-1	c2:aneuploid:low.conf
AAAGGGCAGCTTGAAT-1	c1:diploid:low.conf
AAAGGTAAGCTGTACC-1	c2:aneuploid:low.conf
AAAGTAGCATTGCTCA-1	c2:aneuploid:low.conf
AAAGTCACTGATGTAA-1	c2:aneuploid:low.conf
AAAGTGTGATTTATCT-1	c2:aneuploid:low.conf
AAAGTTGACTCCCGTA-1	c2:aneuploid:low.conf
AAATAACCATACGGGA-1	c2:aneuploid:low.conf
AAATAAGGTAGTGCCC-1	c2:aneuploid:low.conf
AAATACCTATAAGCAT-1	c2:aneuploid:low.conf
AAATAGCTTAGACTTT-1	c1:diploid:low.conf
AAATAGGGTGCTATTG-1	c2:aneuploid:low.conf
AAATCCGATACACGCC-1	c2:aneuploid:low.conf
AAATCGTGTACCACAA-1	c2:aneuploid:low.conf
AAATCTAGCCCTGCTA-1	c2:aneuploid:low.conf
AAATGACTGATCAAAC-1	c1:diploid:low.conf
AAATGATTCGATCAGC-1	c2:aneuploid:low.conf
AAATGCTCGTTACGTT-1	c2:aneuploid:low.conf
AAATGGCATGTCTTGT-1	c2:aneuploid:low.conf
AAATGGTCAATGTGCC-1	c2:aneuploid:low.conf
AAATGTGGGTGCTCCT-1	c2:aneuploid:low.conf
AAATTAACGGGTAGCT-1	c2:aneuploid:low.conf
AAATTACACGACTCTG-1	c2:aneuploid:low.conf
AAATTACCTATCGATG-1	c2:aneuploid:low.conf
AAATTCCAGGTCCAAA-1	c2:aneuploid:low.conf
AAATTGATAGTCCTTT-1	c2:aneuploid:low.conf
AAATTGCGGCGGTTCT-1	c2:aneuploid:low.conf
AAATTGGTGAGAAGCA-1	c2:aneuploid:low.conf
AAATTTACCGAAATCC-1	c2:aneuploid:low.conf
AAATTTGCGGGTGTGG-1	c1:diploid:low.conf
AACAACTGGTAGTTGC-1	c2:aneuploid:low.conf
AACAATACATTGTCGA-1	c1:diploid:low.conf
AACAATTACTCTACGC-1	c2:aneuploid:low.conf
AACACACGCTCGCCGC-1	c2:aneuploid:low.conf
AACACGACTGTACTGA-1	c2:aneuploid:low.conf
AACAGCTGTGTGGCAA-1	c2:aneuploid:low.conf
AACAGGAAATCGAATA-1	c2:aneuploid:low.conf
AACAGGATGGGCCGCG-1	c2:aneuploid:low.conf
AACAGGTAGTATGGAT-1	c2:aneuploid:low.conf
AACATAGCGTGTATCG-1	c2:aneuploid:low.conf
AACATATCAACTGGTG-1	c2:aneuploid:low.conf
AACATCGATACGTCTA-1	c2:aneuploid:low.conf
AACATTGAAGTTGATC-1	c1:diploid:low.conf
AACATTGGTCAGCCGT-1	c2:aneuploid:low.conf
AACATTGTGACTCGAG-1	c2:aneuploid:low.conf
AACCAGTATCACTCTT-1	c2:aneuploid:low.conf
AACCATGGGATCGCTA-1	c2:aneuploid:low.conf
AACCCAGAGACGGAGA-1	c2:aneuploid:low.conf
AACCCGACAACCCGTG-1	c2:aneuploid:low.conf
AACCCGAGCAGAATCG-1	c2:aneuploid:low.conf
AACCCGATAGGGCTTC-1	c2:aneuploid:low.conf
AACCCGCTGTATTCCA-1	c2:aneuploid:low.conf
AACCCTACTGTCAATA-1	c2:aneuploid:low.conf
AACCCTGGTGGAACCA-1	c2:aneuploid:low.conf
AACCGAGCTTGGTCAT-1	c2:aneuploid:low.conf
AACCGCTAAGGGATGC-1	c2:aneuploid:low.conf
AACCGTTGTGTTTGCT-1	c2:aneuploid:low.conf
AACCTCGCTTTAGCCC-1	c2:aneuploid:low.conf
AACCTGTCACGGAATT-1	c1:diploid:low.conf
AACCTTTAAATACGGT-1	c2:aneuploid:low.conf
AACCTTTACGACGTCT-1	c2:aneuploid:low.conf
AACGATAATGCCGTAG-1	c2:aneuploid:low.conf
AACGATAGAAGGGCCG-1	c2:aneuploid:low.conf
AACGATATGTCAACTG-1	c2:aneuploid:low.conf
AACGCATGATCTGGGT-1	c2:aneuploid:low.conf
AACGCGACCTTGGGCG-1	c2:aneuploid:low.conf
AACGCGGTCTCCAGCC-1	c2:aneuploid:low.conf
AACGCTGTTGCTGAAA-1	c2:aneuploid:low.conf
AACGGACGTACGTATA-1	c2:aneuploid:low.conf
AACGGCCATCTCCGGT-1	c1:diploid:low.conf
AACGTACTGTGGGTAC-1	c1:diploid:low.conf
AACGTAGTCTACCCAT-1	c2:aneuploid:low.conf
AACGTCATCCGGCTTG-1	c1:diploid:low.conf
AACGTGATGAAGGACA-1	c2:aneuploid:low.conf
AACGTGCGAAAGTCTC-1	c2:aneuploid:low.conf
AACTACCCGTTTGTCA-1	c2:aneuploid:low.conf
AACTAGCGTATCGCAC-1	c2:aneuploid:low.conf
AACTAGGCTTGGGTGT-1	c2:aneuploid:low.conf
AACTCAAGTTAATTGC-1	c2:aneuploid:low.conf
AACTCCAGAGCGTGTT-1	c2:aneuploid:low.conf
AACTCCTAATCCCATG-1	c2:aneuploid:low.conf
AACTCGATGGCGCAGT-1	c2:aneuploid:low.conf
AACTCTCAATAGAGCG-1	c2:aneuploid:low.conf
AACTCTCAGTGTGCTC-1	c1:diploid:low.conf
AACTGAGGTCAGCGTC-1	c2:aneuploid:low.conf
AACTGAGTTATACTGA-1	c2:aneuploid:low.conf
AACTGATATTAGGCCT-1	c2:aneuploid:low.conf
AACTGGGTCCCGACGT-1	c2:aneuploid:low.conf
AACTGGGTTCGAGCCG-1	c2:aneuploid:low.conf
AACTGGTGTGGGCCTT-1	c2:aneuploid:low.conf
AACTTCTGCGTCTATC-1	c2:aneuploid:low.conf
AACTTGCCCGTATGCA-1	c2:aneuploid:low.conf
AACTTGCGTTCTCGCG-1	c2:aneuploid:low.conf
AACTTTAGCTGCTGAG-1	c2:aneuploid:low.conf
AACTTTCTCGATCATG-1	c2:aneuploid:low.conf
AAGAAATCACCAGATT-1	c2:aneuploid:low.conf
AAGAAGGATCAGTTAG-1	c2:aneuploid:low.conf
AAGACATACGTGGTTT-1	c1:diploid:low.conf
AAGACCCAACTGAACA-1	c2:aneuploid:low.conf
AAGACTAACCCGTTGT-1	c2:aneuploid:low.conf
AAGACTGCAAGCTACT-1	c2:aneuploid:low.conf
AAGAGATGAATCGGTA-1	c2:aneuploid:low.conf
AAGAGCTCTTTATCGG-1	c2:aneuploid:low.conf
AAGAGGCATGGATCGC-1	c1:diploid:low.conf
AAGAGGCCCTTTGGAA-1	c2:aneuploid:low.conf
AAGATGGCACCGGACC-1	c2:aneuploid:low.conf
AAGATTGGCGGAACGT-1	c2:aneuploid:low.conf
AAGCACCCTGCGTATC-1	c2:aneuploid:low.conf
AAGCATACTCTCCTGA-1	c2:aneuploid:low.conf
AAGCCACTTGCAGGTA-1	c2:aneuploid:low.conf
AAGCCGAAGCGGTTTA-1	c2:aneuploid:low.conf
AAGCCGCCGTGAAATC-1	c1:diploid:low.conf
AAGCCGCTTTACCTTG-1	c2:aneuploid:low.conf
AAGCGCAGGGCTTTGA-1	c2:aneuploid:low.conf
AAGCGGAGTGCGCGCA-1	c2:aneuploid:low.conf
AAGCGGCGTCATGGGT-1	c2:aneuploid:low.conf
AAGCGTCCCTCATCGA-1	c2:aneuploid:low.conf
AAGCTAGATCGAGTAA-1	c2:aneuploid:low.conf
AAGCTCGTGCCAAGTC-1	c2:aneuploid:low.conf
AAGCTCTTTCATGGTG-1	c2:aneuploid:low.conf
AAGGAGAACTTATAAG-1	c2:aneuploid:low.conf
AAGGAGCGGTTGGTGC-1	c2:aneuploid:low.conf
AAGGATCGATCGCTTG-1	c2:aneuploid:low.conf
AAGGATGAGGGACCTC-1	c2:aneuploid:low.conf
AAGGCAGGCTGTCTCC-1	c2:aneuploid:low.conf
AAGGCTGTGCTCATCG-1	c2:aneuploid:low.conf
AAGGGAACGACTGGCT-1	c2:aneuploid:low.conf
AAGGGACAGATTCTGT-1	c2:aneuploid:low.conf
AAGGTATCCTAATATA-1	c2:aneuploid:low.conf
AAGGTGATAAACCAGC-1	c2:aneuploid:low.conf
AAGTAAGCTTCCAAAC-1	c2:aneuploid:low.conf
AAGTAGAAGACCGGGT-1	c2:aneuploid:low.conf
AAGTAGTGACGCGAGG-1	c2:aneuploid:low.conf
AAGTCAATTGTCGTCA-1	c2:aneuploid:low.conf
AAGTCTAGTAGCTGCC-1	c2:aneuploid:low.conf
AAGTGAGTCGGGTTTA-1	c2:aneuploid:low.conf
AAGTGCCTTGACTGTA-1	c2:aneuploid:low.conf
AAGTGCTTCTCTATTG-1	c2:aneuploid:low.conf
AAGTGTTTGGAGACGG-1	c2:aneuploid:low.conf
AAGTTCACTCCAAGCT-1	c2:aneuploid:low.conf
AAGTTCAGTCTGCGTA-1	c2:aneuploid:low.conf
AAGTTGTGATGTTATA-1	c1:diploid:low.conf
AAGTTTACTAATGGCA-1	c2:aneuploid:low.conf
AAGTTTATGGGCCCAA-1	c2:aneuploid:low.conf
AATAACACTAGAACAA-1	c1:diploid:low.conf
AATAAGTCCTCGAGAC-1	c2:aneuploid:low.conf
AATAATCTTCGTATCG-1	c2:aneuploid:low.conf
AATACAATGTTTCAGG-1	c2:aneuploid:low.conf
AATACCGGAGGGCTGT-1	c2:aneuploid:low.conf
AATAGAACAGAGTGGC-1	c2:aneuploid:low.conf
AATAGAATCTGTTTCA-1	c2:aneuploid:low.conf
AATAGCAAGCCTCCTG-1	c2:aneuploid:low.conf
AATAGCTACCGCGTGC-1	c2:aneuploid:low.conf
AATAGGCACGACCCTT-1	c2:aneuploid:low.conf
AATAGTCCGTCCCGAC-1	c2:aneuploid:low.conf
AATATCAAGGTCGGAT-1	c2:aneuploid:low.conf
AATATCGAATCAATGC-1	c2:aneuploid:low.conf
AATATCGAGGGTTCTC-1	c2:aneuploid:low.conf
AATCAGGTTTCATTTA-1	c2:aneuploid:low.conf
AATCATGTAAAGACTC-1	c2:aneuploid:low.conf
AATCCAAGGGCCTGAG-1	c2:aneuploid:low.conf
AATCCATGCAAGGGTG-1	c2:aneuploid:low.conf
AATCCCGCTCAGAGCC-1	c1:diploid:low.conf
AATCGCCTCAGCGCCA-1	c2:aneuploid:low.conf
AATCGCGCAGAGGACT-1	c2:aneuploid:low.conf
AATCGGGACACTACGA-1	c2:aneuploid:low.conf
AATCGGTATAGCCCTC-1	c1:diploid:low.conf
AATCGTGAGCCGAGCA-1	c2:aneuploid:low.conf
AATCTATGCCGGAGCC-1	c2:aneuploid:low.conf
AATCTGCGTTGGGACG-1	c2:aneuploid:low.conf
AATCTGGGTAGACCCT-1	c2:aneuploid:low.conf
AATGACAGCAATGTCT-1	c1:diploid:low.conf
AATGACGTAGGATGTC-1	c2:aneuploid:low.conf
AATGACTGTCAGCCGG-1	c2:aneuploid:low.conf
AATGAGTTCGCATATG-1	c2:aneuploid:low.conf
AATGATGATACGCTAT-1	c2:aneuploid:low.conf
AATGATGCGACTCCTG-1	c2:aneuploid:low.conf
AATGCAACCGGGTACC-1	c2:aneuploid:low.conf
AATGCACCAAGCAATG-1	c1:diploid:low.conf
AATGGTTCTCACAAGC-1	c2:aneuploid:low.conf
AATGTGCCCGAGGTGT-1	c2:aneuploid:low.conf
AATGTGCTAATCTGAG-1	c1:diploid:low.conf
AATGTTAAGACCCTGA-1	c2:aneuploid:low.conf
AATGTTGTCGTGAGAC-1	c1:diploid:low.conf
AATTAAAGGTCGGCGT-1	c2:aneuploid:low.conf
AATTAACGGATTTCCA-1	c2:aneuploid:low.conf
AATTAGCGCTGCAGCG-1	c2:aneuploid:low.conf
AATTCATAAGGGATCT-1	c2:aneuploid:low.conf
AATTCCAAGCATGTAC-1	c2:aneuploid:low.conf
AATTCGATTCGAGGAT-1	c2:aneuploid:low.conf
AATTCTAGAGTTAGGC-1	c2:aneuploid:low.conf
AATTGAACGCTCTGGT-1	c2:aneuploid:low.conf
AATTGCAGCAATCGAC-1	c1:diploid:low.conf
AATTTGGGACATAGTA-1	c2:aneuploid:low.conf
AATTTGGTTCCAAAGA-1	c2:aneuploid:low.conf
ACAAACTCCATCAGAG-1	c2:aneuploid:low.conf
ACAAAGCATGACCTAG-1	c1:diploid:low.conf
ACAAATCGCACCGAAT-1	c2:aneuploid:low.conf
ACAAATGGTAGTGTTT-1	c2:aneuploid:low.conf
ACAAATTCAGATCTGA-1	c2:aneuploid:low.conf
ACAACAGCATGAGCTA-1	c2:aneuploid:low.conf
ACAACGGTCCCTGCGA-1	c2:aneuploid:low.conf
ACAAGGAAATCCGCCC-1	c2:aneuploid:low.conf
ACAAGGACAAGAGGTT-1	c2:aneuploid:low.conf
ACAAGGATGCTTTAGG-1	c2:aneuploid:low.conf
ACAAGGCCTACCAGCC-1	c2:aneuploid:low.conf
ACAAGGGCAGGCTCTG-1	c2:aneuploid:low.conf
ACAAGTAATTGTAAGG-1	c2:aneuploid:low.conf
ACAATCGATCTTTATA-1	c2:aneuploid:low.conf
ACAATGAATACGGAGA-1	c2:aneuploid:low.conf
ACAATGATTCTTCTAC-1	c2:aneuploid:low.conf
ACAATTGTGTCTCTTT-1	c2:aneuploid:low.conf
ACAATTTGAGCAGTGG-1	c2:aneuploid:low.conf
ACAATTTGGCCATATT-1	c2:aneuploid:low.conf
ACACAAAGACGGGTGG-1	c2:aneuploid:low.conf
ACACAAATATTCCTAG-1	c2:aneuploid:low.conf
ACACACCAGGACCAGT-1	c2:aneuploid:low.conf
ACACACTTTCTACACG-1	c2:aneuploid:low.conf
ACACATTTCCGTAGAC-1	c2:aneuploid:low.conf
ACACCACATAATTAGC-1	c2:aneuploid:low.conf
ACACCCAGCATGCAGC-1	c2:aneuploid:low.conf
ACACCCGAGAAATCCG-1	c2:aneuploid:low.conf
ACACCTTACTACTTGC-1	c2:aneuploid:low.conf
ACACGAGACTCCTTCT-1	c2:aneuploid:low.conf
ACACGGCACTATGCAT-1	c2:aneuploid:low.conf
ACACGGGAACTTAGGG-1	c2:aneuploid:low.conf
ACACGTAGGCCACAAG-1	c2:aneuploid:low.conf
ACACTCCAATGTCACT-1	c2:aneuploid:low.conf
ACACTGATCAAGGTGT-1	c2:aneuploid:low.conf
ACAGATTAGGTTAGTG-1	c2:aneuploid:low.conf
ACAGCATAGAGCCAGT-1	c2:aneuploid:low.conf
ACAGCGACATTCTCAT-1	c2:aneuploid:low.conf
ACAGCGCACCCGCAGC-1	c2:aneuploid:low.conf
ACAGGCACGGATCCTT-1	c2:aneuploid:low.conf
ACAGGCTTGCCCGACT-1	c2:aneuploid:low.conf
ACAGGTGGAGGTGAGG-1	c1:diploid:low.conf
ACAGTATACCGTGGGA-1	c2:aneuploid:low.conf
ACATAATAAGGCGGTG-1	c2:aneuploid:low.conf
ACATCCCGGCCATACG-1	c2:aneuploid:low.conf
ACATCCTGGTAACTGT-1	c2:aneuploid:low.conf
ACATCGATCGTTTACC-1	c2:aneuploid:low.conf
ACATCGCAATATTCGG-1	c2:aneuploid:low.conf
ACATCGTATGCAATGG-1	c2:aneuploid:low.conf
ACATCGTTAACCTAGT-1	c2:aneuploid:low.conf
ACATCTCAACGCGTAA-1	c2:aneuploid:low.conf
ACATGCTTACGGCAGC-1	c2:aneuploid:low.conf
ACATGGCGCCAAAGTA-1	c2:aneuploid:low.conf
ACATGGCTCAATTTAG-1	c2:aneuploid:low.conf
ACATTAGTTTATATCC-1	c2:aneuploid:low.conf
ACATTCGCGCGGAATA-1	c2:aneuploid:low.conf
ACCAAACACCCAGCGA-1	c2:aneuploid:low.conf
ACCAAACTAGAAATCC-1	c2:aneuploid:low.conf
ACCAACACCACACACT-1	c2:aneuploid:low.conf
ACCAACCGCACTCCAC-1	c1:diploid:low.conf
ACCAACGCTTATTTAT-1	c2:aneuploid:low.conf
ACCAAGAACGCGTGTC-1	c2:aneuploid:low.conf
ACCAAGTCATCGGCAG-1	c1:diploid:low.conf
ACCAATATGCAAGTTA-1	c2:aneuploid:low.conf
ACCACAACTCAGAACA-1	c2:aneuploid:low.conf
ACCACAAGTTTCTATC-1	c2:aneuploid:low.conf
ACCACCAATGTAACAA-1	c2:aneuploid:low.conf
ACCACCCTCTCTTCTA-1	c2:aneuploid:low.conf
ACCACGTGCAGCTATA-1	c2:aneuploid:low.conf
ACCAGCCCGGTCTTTG-1	c2:aneuploid:low.conf
ACCAGGAGTGTGATCT-1	c2:aneuploid:low.conf
ACCAGTGCCCGGTCAA-1	c2:aneuploid:low.conf
ACCAGTGCGGGAGACG-1	c2:aneuploid:low.conf
ACCATATCCGCAATAA-1	c2:aneuploid:low.conf
ACCATCGTATATGGTA-1	c1:diploid:low.conf
ACCCAACGCCCGTGGC-1	c2:aneuploid:low.conf
ACCCACCTACATGCTC-1	c2:aneuploid:low.conf
ACCCATCTTGAGGGTA-1	c2:aneuploid:low.conf
ACCCATTTGTCCCTCT-1	c2:aneuploid:low.conf
ACCCGATTGGTTCCGA-1	c2:aneuploid:low.conf
ACCCGGAAACTCCCAG-1	c2:aneuploid:low.conf
ACCCGGATGACGCATC-1	c2:aneuploid:low.conf
ACCCGGTTACACTTCC-1	c2:aneuploid:low.conf
ACCCGTAGTCTAGTTG-1	c2:aneuploid:low.conf
ACCCGTGTCATCAGTA-1	c2:aneuploid:low.conf
ACCCTATAGGACTGAG-1	c2:aneuploid:low.conf
ACCCTATGCCATATCG-1	c1:diploid:low.conf
ACCCTCCCGTCAGGGC-1	c2:aneuploid:low.conf
ACCCTCCCTTGCTATT-1	c2:aneuploid:low.conf
ACCCTGGTAACGCCCT-1	c2:aneuploid:low.conf
ACCCTTCATCTGCGAA-1	c2:aneuploid:low.conf
ACCCTTGCCTGGGTCG-1	c2:aneuploid:low.conf
ACCCTTTAGTTCTCCA-1	c2:aneuploid:low.conf
ACCGAAAGGGCCCTGC-1	c2:aneuploid:low.conf
ACCGACACATCTCCCA-1	c2:aneuploid:low.conf
ACCGACTGAGTCCCAC-1	c2:aneuploid:low.conf
ACCGAGTCTCCTTATT-1	c2:aneuploid:low.conf
ACCGATATTTAATCAT-1	c2:aneuploid:low.conf
ACCGATGGTAGCATCG-1	c2:aneuploid:low.conf
ACCGCAATAACTGCCT-1	c2:aneuploid:low.conf
ACCGCGGTGGAAGTCG-1	c2:aneuploid:low.conf
ACCGCTAGTCATTGGT-1	c2:aneuploid:low.conf
ACCGGGCCTTTGTTGA-1	c2:aneuploid:low.conf
ACCGTGACCACGTGGG-1	c1:diploid:low.conf
ACCGTTCCCGCTCTGA-1	c2:aneuploid:low.conf
ACCTAAGTACCTTTCA-1	c2:aneuploid:low.conf
ACCTAATCGACTTCCT-1	c2:aneuploid:low.conf
ACCTACAGTATGTGGT-1	c2:aneuploid:low.conf
ACCTACTATAAATCTA-1	c2:aneuploid:low.conf
ACCTCCGCCCTCGCTG-1	c2:aneuploid:low.conf
ACCTCCGTTATTCACC-1	c2:aneuploid:low.conf
ACCTTTCCTTTAGAAG-1	c2:aneuploid:low.conf
ACGACTCTAGGGCCGA-1	c2:aneuploid:low.conf
ACGACTGGTCATACTC-1	c1:diploid:low.conf
ACGAGAACCCATCACG-1	c2:aneuploid:low.conf
ACGAGATATTTGCTTA-1	c2:aneuploid:low.conf
ACGAGTACGGATGCCC-1	c2:aneuploid:low.conf
ACGATACATAGAACTA-1	c2:aneuploid:low.conf
ACGATCATACATAGAG-1	c2:aneuploid:low.conf
ACGATCATCTTGTAAA-1	c2:aneuploid:low.conf
ACGATGCATATGTTAT-1	c2:aneuploid:low.conf
ACGATGGATCCGATGC-1	c2:aneuploid:low.conf
ACGCAAACTAATAGAT-1	c2:aneuploid:low.conf
ACGCAATCACTACAGC-1	c2:aneuploid:low.conf
ACGCATAAATGACATG-1	c2:aneuploid:low.conf
ACGCATACGTTTACTA-1	c2:aneuploid:low.conf
ACGCATTCGTGAGTAC-1	c2:aneuploid:low.conf
ACGCCACTCGAAACAG-1	c2:aneuploid:low.conf
ACGCCAGATGATTTCT-1	c2:aneuploid:low.conf
ACGCCCAGCTGTCGAT-1	c2:aneuploid:low.conf
ACGCCGCTAGACGACC-1	c2:aneuploid:low.conf
ACGCGAAGTCAGACGA-1	c2:aneuploid:low.conf
ACGCGGGCCAAGGACA-1	c2:aneuploid:low.conf
ACGCTAGTGATACACT-1	c2:aneuploid:low.conf
ACGCTTAGTGTCTCTC-1	c2:aneuploid:low.conf
ACGGAATTTAGCAAAT-1	c2:aneuploid:low.conf
ACGGACGCAGCGACAA-1	c1:diploid:low.conf
ACGGACTCTCAAAGCG-1	c2:aneuploid:low.conf
ACGGAGCGCAAATTAC-1	c2:aneuploid:low.conf
ACGGATGGTGCGGATA-1	c2:aneuploid:low.conf
ACGGCACTTGCTTGGG-1	c2:aneuploid:low.conf
ACGGCCAACATGGACT-1	c2:aneuploid:low.conf
ACGGCGACGATGGGAA-1	c2:aneuploid:low.conf
ACGGGCGTATGCGACA-1	c2:aneuploid:low.conf
ACGGTACAGTTCAATG-1	c2:aneuploid:low.conf
ACGTACAGATTTCTCT-1	c2:aneuploid:low.conf
ACGTACTTTGGCACGG-1	c2:aneuploid:low.conf
ACGTAGATTGCTGATG-1	c2:aneuploid:low.conf
ACGTAGGAGAGTCGCT-1	c2:aneuploid:low.conf
ACGTATTACTCCGATC-1	c2:aneuploid:low.conf
ACGTCCTAAACGAGAT-1	c2:aneuploid:low.conf
ACGTGCGCCTCGTGCA-1	c2:aneuploid:low.conf
ACGTGGTCGAATGTGC-1	c2:aneuploid:low.conf
ACGTTAATGTCGAAGA-1	c2:aneuploid:low.conf
ACGTTAGATTTGCCCG-1	c2:aneuploid:low.conf
ACGTTATTGGTCACTC-1	c2:aneuploid:low.conf
ACGTTCACTATGCCGC-1	c2:aneuploid:low.conf
ACGTTCCGCGCTCCGT-1	c2:aneuploid:low.conf
ACGTTCGCAATCAATT-1	c2:aneuploid:low.conf
ACGTTCGTTCAGGAAA-1	c2:aneuploid:low.conf
ACGTTCTGTACAAGTC-1	c1:diploid:low.conf
ACGTTGTCGTTGAAAG-1	c2:aneuploid:low.conf
ACGTTTAGTTGTGATC-1	c1:diploid:low.conf
ACTAAGGACGCACACC-1	c2:aneuploid:low.conf
ACTAATACGTCAGGCG-1	c2:aneuploid:low.conf
ACTACAAAGAGAGGTG-1	c2:aneuploid:low.conf
ACTACCATCCGAGGGC-1	c2:aneuploid:low.conf
ACTACGCGTTAGAATT-1	c2:aneuploid:low.conf
ACTAGTTGCGATCGTC-1	c2:aneuploid:low.conf
ACTATATGCTGTGTTC-1	c2:aneuploid:low.conf
ACTATCCAGGGCATGG-1	c2:aneuploid:low.conf
ACTATCTGCCCGCGTA-1	c2:aneuploid:low.conf
ACTATGTCCAGCTGCC-1	c1:diploid:low.conf
ACTATTCGTCCGTGGT-1	c2:aneuploid:low.conf
ACTATTTCCGGGCCCA-1	c1:diploid:low.conf
ACTCAAGTGCAAGGCT-1	c2:aneuploid:low.conf
ACTCAATAAAGGCACG-1	c2:aneuploid:low.conf
ACTCAGACCTGCTTCT-1	c2:aneuploid:low.conf
ACTCCAATATCATCAT-1	c2:aneuploid:low.conf
ACTCCCGAATTCGTTT-1	c2:aneuploid:low.conf
ACTCCCGTAGACTAGG-1	c2:aneuploid:low.conf
ACTCCCTAATGCTAAA-1	c2:aneuploid:low.conf
ACTCCCTAGAATAGTA-1	c2:aneuploid:low.conf
ACTCCGGCCGACCACT-1	c2:aneuploid:low.conf
ACTCGCCGTTCGATAA-1	c1:diploid:low.conf
ACTCGCGATCTGACGC-1	c2:aneuploid:low.conf
ACTCGTCAGTAATCCC-1	c1:diploid:low.conf
ACTCTCTGACTTAGGT-1	c2:aneuploid:low.conf
ACTCTCTTATACACGA-1	c2:aneuploid:low.conf
ACTCTGACCTAATAGA-1	c1:diploid:low.conf
ACTCTTCAGCTCCCGC-1	c2:aneuploid:low.conf
ACTCTTGTATAGTAAC-1	c2:aneuploid:low.conf
ACTGAAACGCCGTTAG-1	c2:aneuploid:low.conf
ACTGAATGGCGAAAGT-1	c2:aneuploid:low.conf
ACTGATTTAGTGATTC-1	c2:aneuploid:low.conf
ACTGCCCGCCATTCTC-1	c2:aneuploid:low.conf
ACTGCCGTCGTAACTC-1	c2:aneuploid:low.conf
ACTGCGGACACACCGT-1	c1:diploid:low.conf
ACTGGCGAACCTGCGT-1	c2:aneuploid:low.conf
ACTGGGATGCCAGTGC-1	c2:aneuploid:low.conf
ACTGTACGATACACAT-1	c2:aneuploid:low.conf
ACTGTAGCACTTTGGA-1	c2:aneuploid:low.conf
ACTGTATACGCGAGCA-1	c2:aneuploid:low.conf
ACTGTCCAGGATTATA-1	c2:aneuploid:low.conf
ACTGTCTTCTTTAGAA-1	c2:aneuploid:low.conf
ACTGTGCTAGTAGATC-1	c2:aneuploid:low.conf
ACTGTTTAGTGTAGGC-1	c2:aneuploid:low.conf
ACTTACCGGGCGCGCA-1	c2:aneuploid:low.conf
ACTTACGCATCCACGC-1	c2:aneuploid:low.conf
ACTTAGTACGACAAGA-1	c2:aneuploid:low.conf
ACTTATACTTACCCGG-1	c2:aneuploid:low.conf
ACTTATCTGATCTATA-1	c1:diploid:low.conf
ACTTATTAGGATCGGT-1	c2:aneuploid:low.conf
ACTTATTTATGTGCCA-1	c2:aneuploid:low.conf
ACTTCAGGCTGATCCC-1	c2:aneuploid:low.conf
ACTTCCATGCGGGACA-1	c2:aneuploid:low.conf
ACTTCGCCATACGCAC-1	c2:aneuploid:low.conf
ACTTCGCTAGCGAGTG-1	c2:aneuploid:low.conf
ACTTGACTCCCTCTTT-1	c2:aneuploid:low.conf
ACTTGCCATATTGTAC-1	c2:aneuploid:low.conf
ACTTGGGACCCGGTGG-1	c2:aneuploid:low.conf
ACTTGGGCTTTCGCCA-1	c2:aneuploid:low.conf
ACTTGTGGATGGAACG-1	c2:aneuploid:low.conf
ACTTGTTACCGGATCA-1	c1:diploid:low.conf
ACTTTACCCTCATGAA-1	c1:diploid:low.conf
ACTTTCCTATAGCTTC-1	c2:aneuploid:low.conf
AGAAATTATGACTCGC-1	c2:aneuploid:low.conf
AGAACCCAGCGTGACA-1	c2:aneuploid:low.conf
AGAACGTGGTACATTC-1	c2:aneuploid:low.conf
AGAAGGTTGCCGAATT-1	c2:aneuploid:low.conf
AGAAGGTTGTAGGTCG-1	c2:aneuploid:low.conf
AGAATGCGGGTTCGGA-1	c2:aneuploid:low.conf
AGAATTATGGATTCGA-1	c2:aneuploid:low.conf
AGAATTGTTTGACATA-1	c2:aneuploid:low.conf
AGACATAGATCCTTCC-1	c2:aneuploid:low.conf
AGACCATGGGATACAA-1	c2:aneuploid:low.conf
AGACCCACCGCTGATC-1	c2:aneuploid:low.conf
AGACCCGCCCTCCTCG-1	c2:aneuploid:low.conf
AGACCGCTCCGCGGTT-1	c2:aneuploid:low.conf
AGACGAAGTGCCGGTC-1	c2:aneuploid:low.conf
AGACGACGATGCCGCT-1	c2:aneuploid:low.conf
AGACGGGCCGATTTAA-1	c2:aneuploid:low.conf
AGACTAGCCTTCCAGA-1	c2:aneuploid:low.conf
AGACTGTTACCGGGTC-1	c2:aneuploid:low.conf
AGAGAAACACCAGAAA-1	c2:aneuploid:low.conf
AGAGAACCGTCTAGGA-1	c2:aneuploid:low.conf
AGAGAAGGAGTACAAT-1	c2:aneuploid:low.conf
AGAGCCGCCGAGATTT-1	c2:aneuploid:low.conf
AGAGCGCTTGTAACGG-1	c2:aneuploid:low.conf
AGAGCGGGCTAATCAT-1	c2:aneuploid:low.conf
AGAGCGTACAAGCTCG-1	c2:aneuploid:low.conf
AGAGCTACGAAAGCAT-1	c2:aneuploid:low.conf
AGAGGCTTCGGAAACC-1	c2:aneuploid:low.conf
AGAGGGACAATTGTCC-1	c2:aneuploid:low.conf
AGAGGTATCTCGGTCC-1	c2:aneuploid:low.conf
AGAGTAAACTTCACTA-1	c2:aneuploid:low.conf
AGAGTATAGTGTTACG-1	c2:aneuploid:low.conf
AGAGTTAGAGACCGAT-1	c2:aneuploid:low.conf
AGAGTTGCAGGCCTCC-1	c2:aneuploid:low.conf
AGATAACTTCAGGGCC-1	c2:aneuploid:low.conf
AGATACCAGCACTTCA-1	c2:aneuploid:low.conf
AGATACCGGTGTTCAC-1	c2:aneuploid:low.conf
AGATACGACTTCATAT-1	c2:aneuploid:low.conf
AGATACTCAAGATCGA-1	c2:aneuploid:low.conf
AGATATAATACGACTA-1	c2:aneuploid:low.conf
AGATCGTGCATAAGAT-1	c2:aneuploid:low.conf
AGATCTCAGGTGTGAT-1	c2:aneuploid:low.conf
AGATGACTCGCCCACG-1	c2:aneuploid:low.conf
AGATGAGGGTTGCGAT-1	c1:diploid:low.conf
AGATGATGGAGTCTGG-1	c2:aneuploid:low.conf
AGATTATAGGACGTTT-1	c2:aneuploid:low.conf
AGCAAAGGCCGCTAGT-1	c2:aneuploid:low.conf
AGCAACATATCTTATT-1	c2:aneuploid:low.conf
AGCACACGTTTAGACT-1	c1:diploid:low.conf
AGCACCAGTACTCACG-1	c2:aneuploid:low.conf
AGCACTACCTCACCAG-1	c2:aneuploid:low.conf
AGCACTTAAGGACGCC-1	c2:aneuploid:low.conf
AGCAGAAGGAGAAAGA-1	c2:aneuploid:low.conf
AGCAGCCAGATGAATA-1	c2:aneuploid:low.conf
AGCAGTCGAAGCATGC-1	c2:aneuploid:low.conf
AGCATATCAATATGCT-1	c2:aneuploid:low.conf
AGCATCGTCGATAATT-1	c2:aneuploid:low.conf
AGCATTACGAGGCAAG-1	c1:diploid:low.conf
AGCCAAGCTTTGTGTC-1	c2:aneuploid:low.conf
AGCCACAGGTTACCCG-1	c2:aneuploid:low.conf
AGCCACTCCCGTGCTT-1	c2:aneuploid:low.conf
AGCCATATAGTATGTG-1	c2:aneuploid:low.conf
AGCCCGCAACAAGCAG-1	c2:aneuploid:low.conf
AGCCCGGCATTAGAGG-1	c1:diploid:low.conf
AGCCCGGTAGCCTGTA-1	c2:aneuploid:low.conf
AGCCCTAAGCGAAGTT-1	c2:aneuploid:low.conf
AGCCCTCCCTGGTGGC-1	c1:diploid:low.conf
AGCCCTGTCGCACCGT-1	c1:diploid:low.conf
AGCCCTTCTAATCCGA-1	c1:diploid:low.conf
AGCCTTAAAGCGGAAG-1	c2:aneuploid:low.conf
AGCGACAGGAACGGTC-1	c1:diploid:low.conf
AGCGACATCCCATTCA-1	c2:aneuploid:low.conf
AGCGACCAACGATATT-1	c2:aneuploid:low.conf
AGCGACTTTGAAGACA-1	c1:diploid:low.conf
AGCGAGACGTGAAGGC-1	c1:diploid:low.conf
AGCGCATAATGAATCG-1	c2:aneuploid:low.conf
AGCGCGGGTGCCAATG-1	c2:aneuploid:low.conf
AGCGCTAGAGCGATGT-1	c2:aneuploid:low.conf
AGCGCTTATGGGCAAG-1	c2:aneuploid:low.conf
AGCGGACACTTCGTAG-1	c2:aneuploid:low.conf
AGCGGGAAGGGTCCAT-1	c2:aneuploid:low.conf
AGCGGGTCTGACACTC-1	c2:aneuploid:low.conf
AGCGGTTGCCGCTCTG-1	c2:aneuploid:low.conf
AGCGTACGAGAGCTAG-1	c2:aneuploid:low.conf
AGCGTGGTATTCTACT-1	c2:aneuploid:low.conf
AGCTAACAAGCAATGT-1	c2:aneuploid:low.conf
AGCTAAGCTCCGTCCG-1	c2:aneuploid:low.conf
AGCTAAGTACGCAGGC-1	c2:aneuploid:low.conf
AGCTAGAAGCAGAAGT-1	c1:diploid:low.conf
AGCTATTTAATCCAAC-1	c2:aneuploid:low.conf
AGCTCCATATATGTTC-1	c2:aneuploid:low.conf
AGCTCCTTCGCACATC-1	c2:aneuploid:low.conf
AGCTCGTTGATGGAAA-1	c2:aneuploid:low.conf
AGCTCTAGACGTTCCA-1	c2:aneuploid:low.conf
AGCTCTTCCCAGTGCA-1	c2:aneuploid:low.conf
AGCTCTTCGTAACCTT-1	c2:aneuploid:low.conf
AGCTCTTTACTCAGTT-1	c2:aneuploid:low.conf
AGCTGAAGTAAACCAA-1	c2:aneuploid:low.conf
AGCTGTAACCTCAATC-1	c2:aneuploid:low.conf
AGCTTATAGAGACCTG-1	c2:aneuploid:low.conf
AGCTTCTTCTCGAGCA-1	c1:diploid:low.conf
AGGAAAGCCTCTGATG-1	c2:aneuploid:low.conf
AGGAAGCTGTCCGCCG-1	c2:aneuploid:low.conf
AGGACAGTCGAATCCC-1	c2:aneuploid:low.conf
AGGACATCGCACGTCG-1	c2:aneuploid:low.conf
AGGACGACCCATTAGA-1	c2:aneuploid:low.conf
AGGACGCTCGATGTTG-1	c1:diploid:low.conf
AGGAGACATCCACAGT-1	c2:aneuploid:low.conf
AGGAGAGTCTGGCTAC-1	c2:aneuploid:low.conf
AGGAGGCCTTCGCGCG-1	c2:aneuploid:low.conf
AGGATAAAGTCGGGAT-1	c2:aneuploid:low.conf
AGGATATAGGGATTTA-1	c2:aneuploid:low.conf
AGGATATCCGACTGCA-1	c2:aneuploid:low.conf
AGGATTGCTTACGACA-1	c2:aneuploid:low.conf
AGGCAAAGAGGAATCA-1	c2:aneuploid:low.conf
AGGCACGTGACTGTCC-1	c2:aneuploid:low.conf
AGGCAGATGCGTAAAC-1	c2:aneuploid:low.conf
AGGCAGGGAGCGTACT-1	c2:aneuploid:low.conf
AGGCATTGTCGTAGGG-1	c2:aneuploid:low.conf
AGGCCACATTGGTTAC-1	c2:aneuploid:low.conf
AGGCCACCCGTTATGA-1	c2:aneuploid:low.conf
AGGCCCAGTGACTGGT-1	c2:aneuploid:low.conf
AGGCCTATCATACCAA-1	c2:aneuploid:low.conf
AGGCCTGAGAATCTCG-1	c1:diploid:low.conf
AGGCGTCTATGGACGG-1	c2:aneuploid:low.conf
AGGCTATGGTTAGCTT-1	c2:aneuploid:low.conf
AGGCTTAAGTTGCACA-1	c2:aneuploid:low.conf
AGGCTTCCCGAAGAAG-1	c2:aneuploid:low.conf
AGGCTTGCTAGACACC-1	c2:aneuploid:low.conf
AGGGAAACGAGGTACT-1	c2:aneuploid:low.conf
AGGGACAGCACGGCGG-1	c2:aneuploid:low.conf
AGGGACCGGCTGCGTT-1	c2:aneuploid:low.conf
AGGGACTCTACGCGAC-1	c2:aneuploid:low.conf
AGGGAGACATACTTCG-1	c2:aneuploid:low.conf
AGGGCAGCGGCGTGGT-1	c2:aneuploid:low.conf
AGGGCGTGATCGGCTA-1	c2:aneuploid:low.conf
AGGGCTGCAGTTACAG-1	c2:aneuploid:low.conf
AGGGTCAGAGCACTCG-1	c2:aneuploid:low.conf
AGGGTCAGTAACCCTA-1	c2:aneuploid:low.conf
AGGGTCGATGCGAACT-1	c2:aneuploid:low.conf
AGGGTGCCGTTCTTTA-1	c1:diploid:low.conf
AGGGTGCTCTCGAGGG-1	c2:aneuploid:low.conf
AGGGTTCAGACGGTCC-1	c2:aneuploid:low.conf
AGGGTTCCCTTTGGTT-1	c2:aneuploid:low.conf
AGGGTTTAGTTCGGGA-1	c2:aneuploid:low.conf
AGGTAACCTCCTATTC-1	c2:aneuploid:low.conf
AGGTACGATATTGCCA-1	c2:aneuploid:low.conf
AGGTAGATCGAGATAT-1	c1:diploid:low.conf
AGGTAGGTACAAAGCT-1	c2:aneuploid:low.conf
AGGTATAATTGATAGT-1	c2:aneuploid:low.conf
AGGTATGCGGACATTA-1	c2:aneuploid:low.conf
AGGTCGCGGAGTTACT-1	c1:diploid:low.conf
AGGTGCACGTCCACAT-1	c1:diploid:low.conf
AGGTGGTGACCTTCGC-1	c2:aneuploid:low.conf
AGGTTACACCATGCCG-1	c2:aneuploid:low.conf
AGGTTGAGGCACGCTT-1	c2:aneuploid:low.conf
AGGTTTCACACACCTT-1	c2:aneuploid:low.conf
AGTAACGTTCATCCTG-1	c2:aneuploid:low.conf
AGTAACTATAGCAGCC-1	c1:diploid:low.conf
AGTAATCTAAGGGTGG-1	c2:aneuploid:low.conf
AGTAATGTCTTGCCGC-1	c2:aneuploid:low.conf
AGTACAGAAGCTTATA-1	c2:aneuploid:low.conf
AGTACATCATTTATCA-1	c2:aneuploid:low.conf
AGTACCTTCGAGTGCT-1	c2:aneuploid:low.conf
AGTACGGGCACCTGGC-1	c2:aneuploid:low.conf
AGTACGTGGCCTGTCT-1	c2:aneuploid:low.conf
AGTACTCTTATGCCCA-1	c2:aneuploid:low.conf
AGTAGAAGGCGCCTCA-1	c2:aneuploid:low.conf
AGTAGCGTGAACGAAC-1	c2:aneuploid:low.conf
AGTAGCTAGACGCCGA-1	c2:aneuploid:low.conf
AGTAGGAAGGAAGTTG-1	c1:diploid:low.conf
AGTAGGTAACATACAT-1	c2:aneuploid:low.conf
AGTATAATACTAGGCA-1	c2:aneuploid:low.conf
AGTATACACAGCGACA-1	c2:aneuploid:low.conf
AGTATGCTGGAGACCA-1	c2:aneuploid:low.conf
AGTATTTGGCACGACC-1	c2:aneuploid:low.conf
AGTCAAATGATGTGAT-1	c2:aneuploid:low.conf
AGTCAACACCACCATC-1	c2:aneuploid:low.conf
AGTCAAGATGACACTT-1	c2:aneuploid:low.conf
AGTCACTAGCTCTCGA-1	c2:aneuploid:low.conf
AGTCAGCCACCGCCTG-1	c2:aneuploid:low.conf
AGTCCATTGGCTGATG-1	c2:aneuploid:low.conf
AGTCCCGCCTTTAATT-1	c2:aneuploid:low.conf
AGTCCCTCGCAGAAAG-1	c2:aneuploid:low.conf
AGTCGACGGTCTCAAG-1	c2:aneuploid:low.conf
AGTCGGTTGCGTGAGA-1	c2:aneuploid:low.conf
AGTCGTATAAAGCAGA-1	c2:aneuploid:low.conf
AGTCGTCGACCACCAA-1	c2:aneuploid:low.conf
AGTCGTGGGCATTACG-1	c2:aneuploid:low.conf
AGTCTAAAGTATACTC-1	c2:aneuploid:low.conf
AGTCTCACAAGACTAC-1	c2:aneuploid:low.conf
AGTCTGGACATCCTTG-1	c2:aneuploid:low.conf
AGTCTTCTCCTCAAAT-1	c2:aneuploid:low.conf
AGTCTTTAAAGTGTCC-1	c2:aneuploid:low.conf
AGTGAACAAACTTCTC-1	c2:aneuploid:low.conf
AGTGAAGATGGTGTCC-1	c1:diploid:low.conf
AGTGACCTACTTTACG-1	c2:aneuploid:low.conf
AGTGACTGTGACACAA-1	c1:diploid:low.conf
AGTGAGACTTCCAGTA-1	c2:aneuploid:low.conf
AGTGAGCCTCGCCGCC-1	c2:aneuploid:low.conf
AGTGAGGGTTTCTGAC-1	c2:aneuploid:low.conf
AGTGAGTCGAATTAAC-1	c1:diploid:low.conf
AGTGATAACCTGCGCG-1	c2:aneuploid:low.conf
AGTGATATGAGTAGTT-1	c2:aneuploid:low.conf
AGTGATTCAAGCAGGA-1	c2:aneuploid:low.conf
AGTGCACGCTTAAGAA-1	c2:aneuploid:low.conf
AGTGCGTAGCTCGTAA-1	c1:diploid:low.conf
AGTGCTAAACACAGCA-1	c1:diploid:low.conf
AGTGCTTGCACGAATA-1	c2:aneuploid:low.conf
AGTGGCGGCAATTTGA-1	c2:aneuploid:low.conf
AGTGGCGTCTGAAGGT-1	c2:aneuploid:low.conf
AGTGTATTGCGCATTG-1	c1:diploid:low.conf
AGTGTGGTCTATTGTG-1	c2:aneuploid:low.conf
AGTTAAACACTTGCGA-1	c1:diploid:low.conf
AGTTAAGCGGTCCCGG-1	c2:aneuploid:low.conf
AGTTACCGCACATGGT-1	c2:aneuploid:low.conf
AGTTACTCTATCGTGG-1	c2:aneuploid:low.conf
AGTTATTGAAAGGTAA-1	c1:diploid:low.conf
AGTTCCTACAGAATTA-1	c2:aneuploid:low.conf
AGTTCCTATTTATGTT-1	c2:aneuploid:low.conf
AGTTCTGCGTTGTATC-1	c2:aneuploid:low.conf
AGTTGACATCGGCTGG-1	c2:aneuploid:low.conf
AGTTGACGGTCCTTGC-1	c2:aneuploid:low.conf
AGTTGCTGACTGATAT-1	c2:aneuploid:low.conf
AGTTGGCAAGGCTAGA-1	c1:diploid:low.conf
AGTTTATGTAAAGACA-1	c2:aneuploid:low.conf
AGTTTCGCAGGTCGGA-1	c2:aneuploid:low.conf
AGTTTGCACCTGCCTC-1	c2:aneuploid:low.conf
AGTTTGGCACGGGTTG-1	c2:aneuploid:low.conf
ATAAACCATTGGACGG-1	c2:aneuploid:low.conf
ATAAACGGACCCGTAA-1	c2:aneuploid:low.conf
ATAAACGTTGCACCAC-1	c2:aneuploid:low.conf
ATAAAGGCTCGGTCGT-1	c1:diploid:low.conf
ATAAAGGTCAAGTACG-1	c2:aneuploid:low.conf
ATAACGCCGGAGGGTC-1	c1:diploid:low.conf
ATAACGGAGTCCAACG-1	c2:aneuploid:low.conf
ATAACGTTACCTCCAC-1	c2:aneuploid:low.conf
ATAAGCAAACACCGAG-1	c2:aneuploid:low.conf
ATAAGGTGGAGAACAT-1	c2:aneuploid:low.conf
ATAAGTACCCGATTGT-1	c2:aneuploid:low.conf
ATAAGTAGGATTCAGA-1	c1:diploid:low.conf
ATAAGTAGGGCGACTC-1	c2:aneuploid:low.conf
ATAAGTTACCGCGACG-1	c2:aneuploid:low.conf
ATAATACCGTTAGCCG-1	c2:aneuploid:low.conf
ATAATAGCTGTTGAAT-1	c2:aneuploid:low.conf
ATAATAGTGTAGGGAC-1	c2:aneuploid:low.conf
ATAATCTTGGAGAACC-1	c2:aneuploid:low.conf
ATAATTAGCTAAGTAG-1	c2:aneuploid:low.conf
ATACAGGCCCTCCAAT-1	c2:aneuploid:low.conf
ATACCAGCAAATTGCT-1	c2:aneuploid:low.conf
ATACCAGGCTAATAGA-1	c2:aneuploid:low.conf
ATACCAGGTGAGCGAT-1	c2:aneuploid:low.conf
ATACCGTCATCCATAA-1	c2:aneuploid:low.conf
ATACCTAACCAAGAAA-1	c2:aneuploid:low.conf
ATACGAAGGCTTTCCA-1	c2:aneuploid:low.conf
ATACGAGGTTTGTAAG-1	c1:diploid:low.conf
ATACGCCGATCTACCG-1	c2:aneuploid:low.conf
ATACGCCGGCGAAACC-1	c2:aneuploid:low.conf
ATACGGGTTTCGATTG-1	c2:aneuploid:low.conf
ATACGTACTTAGCCAC-1	c2:aneuploid:low.conf
ATACGTCCACTCCTGT-1	c2:aneuploid:low.conf
ATACGTTATGCACGGA-1	c2:aneuploid:low.conf
ATACTACCCGTACCAC-1	c2:aneuploid:low.conf
ATACTAGCATGACCCT-1	c2:aneuploid:low.conf
ATACTCTCGCCACTCT-1	c2:aneuploid:low.conf
ATACTGCCTTACACCG-1	c2:aneuploid:low.conf
ATAGACAACGGGACCT-1	c2:aneuploid:low.conf
ATAGACGAAGAGAAAG-1	c2:aneuploid:low.conf
ATAGAGTTATCAACTT-1	c2:aneuploid:low.conf
ATAGATTTGCAGTCGG-1	c2:aneuploid:low.conf
ATAGCAACTAGGGAAG-1	c1:diploid:low.conf
ATAGCCTCAGTACCCA-1	c2:aneuploid:low.conf
ATAGGAATCTAAGCTT-1	c2:aneuploid:low.conf
ATAGGCTAGCTTCGCA-1	c2:aneuploid:low.conf
ATAGGGATATCCTTGA-1	c2:aneuploid:low.conf
ATAGGTTGGGCAGATG-1	c2:aneuploid:low.conf
ATAGTCTTTGACGTGC-1	c2:aneuploid:low.conf
ATAGTGAAGCGTTCTC-1	c2:aneuploid:low.conf
ATAGTTCCACCCACTC-1	c2:aneuploid:low.conf
ATATAAAGCGCTCGTG-1	c2:aneuploid:low.conf
ATATAAATGTAGCTGC-1	c2:aneuploid:low.conf
ATATAACACGGGCGCA-1	c2:aneuploid:low.conf
ATATCAACCTACAGAG-1	c1:diploid:low.conf
ATATCGGTAGGGAGAT-1	c2:aneuploid:low.conf
ATATCGTGCCAGACCC-1	c2:aneuploid:low.conf
ATATCGTTCCTCGAAC-1	c2:aneuploid:low.conf
ATATCTCCCTCGTTAA-1	c2:aneuploid:low.conf
ATATCTTAGGGCCTTC-1	c2:aneuploid:low.conf
ATATGGGATAGCAACT-1	c2:aneuploid:low.conf
ATATGTCTAGAGCGTG-1	c2:aneuploid:low.conf
ATATGTCTCCCTAGCC-1	c2:aneuploid:low.conf
ATATGTGCACAAACCA-1	c2:aneuploid:low.conf
ATATTCAGTTAAACCT-1	c2:aneuploid:low.conf
ATATTCCACATAGTGA-1	c2:aneuploid:low.conf
ATATTCCCACAGGTCA-1	c2:aneuploid:low.conf
ATATTGCTGTCAAAGT-1	c2:aneuploid:low.conf
ATATTTAACCCTCAAG-1	c2:aneuploid:low.conf
ATCAAACACTGTTCCA-1	c2:aneuploid:low.conf
ATCAAACGAAGGTTTG-1	c2:aneuploid:low.conf
ATCAAAGAGCCGTGGT-1	c1:diploid:low.conf
ATCAAGATCCCAGGAC-1	c2:aneuploid:low.conf
ATCAATCTGGGCTGCA-1	c2:aneuploid:low.conf
ATCACATTAGAATATC-1	c2:aneuploid:low.conf
ATCACGTGCTAATTAA-1	c2:aneuploid:low.conf
ATCACTTCATCCTCGC-1	c2:aneuploid:low.conf
ATCAGACGGCACGCCG-1	c2:aneuploid:low.conf
ATCAGCCTCATGCTGC-1	c2:aneuploid:low.conf
ATCAGGTAGCTGACAG-1	c2:aneuploid:low.conf
ATCAGGTCGCCATTGC-1	c2:aneuploid:low.conf
ATCAGTAGGCAGGGAT-1	c2:aneuploid:low.conf
ATCATAGATCGACGAG-1	c1:diploid:low.conf
ATCATAGCCCTATGTA-1	c2:aneuploid:low.conf
ATCATCCAATATTTGT-1	c1:diploid:low.conf
ATCATGGACTACCGAC-1	c2:aneuploid:low.conf
ATCCAACGCAGTCATA-1	c2:aneuploid:low.conf
ATCCACATCGACAGAA-1	c2:aneuploid:low.conf
ATCCACGCTAAATGTT-1	c2:aneuploid:low.conf
ATCCACTTTCAGACTA-1	c2:aneuploid:low.conf
ATCCAGAGCAACAACC-1	c2:aneuploid:low.conf
ATCCAGGATTCGTGAA-1	c1:diploid:low.conf
ATCCCATTTCCGTGGG-1	c2:aneuploid:low.conf
ATCCTACCTAAGCTCT-1	c2:aneuploid:low.conf
ATCCTGCGTGGAATGG-1	c2:aneuploid:low.conf
ATCCTGCTGCAGATAG-1	c2:aneuploid:low.conf
ATCCTTCTGAAAGAAC-1	c2:aneuploid:low.conf
ATCGACCCAATACAGA-1	c1:diploid:low.conf
ATCGACTCTTTCCGTT-1	c2:aneuploid:low.conf
ATCGCACGATTGTTCA-1	c2:aneuploid:low.conf
ATCGCACGCCGGGAGA-1	c2:aneuploid:low.conf
ATCGCCAGTCAACATT-1	c2:aneuploid:low.conf
ATCGCTGCGTGCAGCA-1	c2:aneuploid:low.conf
ATCGCTTTACGTCTCA-1	c2:aneuploid:low.conf
ATCGGAGACAGACGGC-1	c2:aneuploid:low.conf
ATCGGCAAGCAGTCCA-1	c2:aneuploid:low.conf
ATCGTCCAATCGAGTC-1	c2:aneuploid:low.conf
ATCGTTAGCTAGCGGA-1	c2:aneuploid:low.conf
ATCGTTCACTTTCGCC-1	c1:diploid:low.conf
ATCTAATATCCTACGG-1	c2:aneuploid:low.conf
ATCTACCATCTGCTCC-1	c2:aneuploid:low.conf
ATCTAGCTTGTGAGGG-1	c2:aneuploid:low.conf
ATCTCCCACGGAATAT-1	c2:aneuploid:low.conf
ATCTCCCTGCAATCTA-1	c2:aneuploid:low.conf
ATCTCGTGAGCGAAAC-1	c2:aneuploid:low.conf
ATCTGACATGGAAGGA-1	c1:diploid:low.conf
ATCTGATAGTGTCTTA-1	c2:aneuploid:low.conf
ATCTGCACCTCTGCGA-1	c2:aneuploid:low.conf
ATCTGCTGTTATCGCC-1	c2:aneuploid:low.conf
ATCTGGGCTGTTCTTG-1	c2:aneuploid:low.conf
ATCTGGTTAAGACTGT-1	c2:aneuploid:low.conf
ATCTGTAATTGTACCC-1	c2:aneuploid:low.conf
ATCTTATCGCACACCC-1	c1:diploid:low.conf
ATCTTGACCTGCAACG-1	c2:aneuploid:low.conf
ATCTTGACTTGTCCAA-1	c1:diploid:low.conf
ATCTTTCGTATAACCA-1	c2:aneuploid:low.conf
ATGAAGCCAAGGAGCC-1	c2:aneuploid:low.conf
ATGACGCCGGCTCTAA-1	c2:aneuploid:low.conf
ATGACGCGTTCTATCC-1	c2:aneuploid:low.conf
ATGACTATCAGCTGTG-1	c2:aneuploid:low.conf
ATGACTATGCGACATT-1	c2:aneuploid:low.conf
ATGAGGAGTGTTAATC-1	c2:aneuploid:low.conf
ATGAGGGCAGCGGCTA-1	c1:diploid:low.conf
ATGATCGGGAATAGAC-1	c2:aneuploid:low.conf
ATGATGCAATGGTACA-1	c2:aneuploid:low.conf
ATGCATGATCCAGGAT-1	c2:aneuploid:low.conf
ATGCATTCCGTGATGG-1	c2:aneuploid:low.conf
ATGCCAATCGCTCTGC-1	c2:aneuploid:low.conf
ATGCCATTTGCGACCA-1	c2:aneuploid:low.conf
ATGCCGGTCTTGCATA-1	c2:aneuploid:low.conf
ATGCCGGTTGATGGGA-1	c2:aneuploid:low.conf
ATGCGACAATTGGTCC-1	c2:aneuploid:low.conf
ATGCGACAGTCCCATT-1	c2:aneuploid:low.conf
ATGCGAGTCCCACCAC-1	c2:aneuploid:low.conf
ATGCTCAGTGTTGCAT-1	c2:aneuploid:low.conf
ATGCTCTGGCGCGGTA-1	c2:aneuploid:low.conf
ATGCTTAGGAGTTGAT-1	c2:aneuploid:low.conf
ATGGAACCTTTGCACA-1	c1:diploid:low.conf
ATGGACTGCTTAGTTG-1	c2:aneuploid:low.conf
ATGGAGCAGGCCGTGA-1	c2:aneuploid:low.conf
ATGGATCCGGCGTCCG-1	c2:aneuploid:low.conf
ATGGATTGACCAAACG-1	c1:diploid:low.conf
ATGGCGGAATAGTCGC-1	c2:aneuploid:low.conf
ATGGCTGGAAATGGCC-1	c2:aneuploid:low.conf
ATGGGAACGGAAGCGG-1	c2:aneuploid:low.conf
ATGGGACCTGCTGAAC-1	c2:aneuploid:low.conf
ATGGGCCTCGGCCTCT-1	c2:aneuploid:low.conf
ATGGGTGTATACCTCC-1	c2:aneuploid:low.conf
ATGGTATTGGGAACCG-1	c2:aneuploid:low.conf
ATGGTCGCGTGGTTTC-1	c2:aneuploid:low.conf
ATGGTGCTCAAAGCCA-1	c2:aneuploid:low.conf
ATGGTTACGAAACATG-1	c2:aneuploid:low.conf
ATGTAAGGCTGCTCTT-1	c2:aneuploid:low.conf
ATGTACGATGACGTCG-1	c2:aneuploid:low.conf
ATGTAGCGCGCGTAGG-1	c2:aneuploid:low.conf
ATGTCATAATAAACGA-1	c1:diploid:low.conf
ATGTCTTGTTTGACTC-1	c2:aneuploid:low.conf
ATGTGCATCCGACGCA-1	c2:aneuploid:low.conf
ATGTGGACATCTTGAT-1	c2:aneuploid:low.conf
ATGTGTAGTTTAGTCA-1	c2:aneuploid:low.conf
ATGTTACGAGCAATAC-1	c2:aneuploid:low.conf
ATGTTGATTAGAGACT-1	c2:aneuploid:low.conf
ATGTTGTAGTCTGTTT-1	c2:aneuploid:low.conf
ATGTTTCGGCCCGGAG-1	c2:aneuploid:low.conf
ATTAAACATGCGGACC-1	c2:aneuploid:low.conf
ATTAATACTACGCGGG-1	c2:aneuploid:low.conf
ATTAATGAACCAGTCG-1	c2:aneuploid:low.conf
ATTAATTCGGTCACTC-1	c1:diploid:low.conf
ATTACAACTACCGGCC-1	c2:aneuploid:low.conf
ATTACATGTCAGTCTT-1	c2:aneuploid:low.conf
ATTACCACACTGCCTG-1	c2:aneuploid:low.conf
ATTACGACTCCACAGT-1	c2:aneuploid:low.conf
ATTACTAGCCTCTTGC-1	c2:aneuploid:low.conf
ATTACTTACTGGGCAT-1	c1:diploid:low.conf
ATTAGATTCCTCAGCA-1	c1:diploid:low.conf
ATTAGATTGATAGCGG-1	c2:aneuploid:low.conf
ATTAGGCGATGCTTTC-1	c2:aneuploid:low.conf
ATTATACTTTGCTCGT-1	c2:aneuploid:low.conf
ATTATAGCTACTTTAC-1	c2:aneuploid:low.conf
ATTATCGGAATGTACG-1	c2:aneuploid:low.conf
ATTATCTCGACAGATC-1	c2:aneuploid:low.conf
ATTATGCCATAGGGAG-1	c2:aneuploid:low.conf
ATTATTATGTCCGTCA-1	c2:aneuploid:low.conf
ATTATTCAGAGTCACT-1	c1:diploid:low.conf
ATTCAACCATTTAAGG-1	c2:aneuploid:low.conf
ATTCACTGATGTTGGA-1	c2:aneuploid:low.conf
ATTCAGGACCTATTTC-1	c1:diploid:low.conf
ATTCAGTAGCAGGGTC-1	c2:aneuploid:low.conf
ATTCATATACTGTCCA-1	c2:aneuploid:low.conf
ATTCATCGTTGAGGCA-1	c2:aneuploid:low.conf
ATTCCCACATAAACAA-1	c2:aneuploid:low.conf
ATTCCTAAGACGTGGA-1	c2:aneuploid:low.conf
ATTCCTTCCAGGCGGT-1	c2:aneuploid:low.conf
ATTCGCAGAGGACACT-1	c1:diploid:low.conf
ATTCGCGCCTTGAGAG-1	c1:diploid:low.conf
ATTCGTGCTATCTCTT-1	c2:aneuploid:low.conf
ATTCTCGTCTCTTTAG-1	c2:aneuploid:low.conf
ATTCTGAGTATGAACT-1	c2:aneuploid:low.conf
ATTCTTCGTACTTATG-1	c2:aneuploid:low.conf
ATTGAAGATCTTAGTG-1	c2:aneuploid:low.conf
ATTGACCGGCGATGAC-1	c2:aneuploid:low.conf
ATTGACGTAACTCGGT-1	c2:aneuploid:low.conf
ATTGATAGCAACGAGA-1	c2:aneuploid:low.conf
ATTGATGAGTCCTAAC-1	c2:aneuploid:low.conf
ATTGCCTATTAGACCG-1	c1:diploid:low.conf
ATTGCCTTTATGTTTG-1	c2:aneuploid:low.conf
ATTGCGATCAGTAACT-1	c2:aneuploid:low.conf
ATTGCTGCTCCTCCAT-1	c2:aneuploid:low.conf
ATTGGATTACAGCGTA-1	c2:aneuploid:low.conf
ATTGGGAATATCTTGG-1	c2:aneuploid:low.conf
ATTGGGAGTTCTGTAA-1	c2:aneuploid:low.conf
ATTGGTTGTGCATTAC-1	c1:diploid:low.conf
ATTGTACAACTCGGCT-1	c2:aneuploid:low.conf
ATTGTCGCAATACCTT-1	c2:aneuploid:low.conf
ATTGTCTGTTTCATGT-1	c2:aneuploid:low.conf
ATTGTGACTTCGCTGC-1	c2:aneuploid:low.conf
ATTTAACTCGTATTAC-1	c2:aneuploid:low.conf
ATTTACAGTTTACTGG-1	c2:aneuploid:low.conf
ATTTACTAAGTCCATT-1	c2:aneuploid:low.conf
ATTTATACTGGTAAAG-1	c2:aneuploid:low.conf
ATTTCATTATTTCGCG-1	c2:aneuploid:low.conf
ATTTCCGGGTTCTGCG-1	c2:aneuploid:low.conf
ATTTGCCTAGTTACGA-1	c2:aneuploid:low.conf
ATTTGCGCGAGTAGCT-1	c2:aneuploid:low.conf
ATTTGTCTTGGGAGCT-1	c2:aneuploid:low.conf
ATTTGTTCCAGGGCTC-1	c2:aneuploid:low.conf
CAAACCCTCCGGCGGG-1	c2:aneuploid:low.conf
CAAACGAGTATCGCAG-1	c2:aneuploid:low.conf
CAAACGGTCGCACTTT-1	c2:aneuploid:low.conf
CAAACGTGGTCTTGCG-1	c2:aneuploid:low.conf
CAAACTACGATAGAGA-1	c2:aneuploid:low.conf
CAAACTATTGAGCTTC-1	c2:aneuploid:low.conf
CAAACTCGCGACGCCG-1	c2:aneuploid:low.conf
CAAAGATTATTGGGCC-1	c2:aneuploid:low.conf
CAAAGGTCATCTGAAA-1	c2:aneuploid:low.conf
CAAAGGTTAAATTCAG-1	c2:aneuploid:low.conf
CAAAGTCAGGTTAGCT-1	c2:aneuploid:low.conf
CAAATGCGGAGTGTTC-1	c2:aneuploid:low.conf
CAAATGTCCTTCCGTG-1	c2:aneuploid:low.conf
CAAATTGGATTATGCC-1	c2:aneuploid:low.conf
CAAATTGTCAGCAAGC-1	c2:aneuploid:low.conf
CAACACATCTCCTGCC-1	c1:diploid:low.conf
CAACAGTGCCAAACGG-1	c2:aneuploid:low.conf
CAACCTACCGAGCAGT-1	c2:aneuploid:low.conf
CAACCTGAACCTGCCA-1	c2:aneuploid:low.conf
CAACGACCCGTTTACA-1	c2:aneuploid:low.conf
CAACGCGATGAGCCAA-1	c2:aneuploid:low.conf
CAACGGTTCTTGATAC-1	c2:aneuploid:low.conf
CAACGTGGTGGAGTCT-1	c2:aneuploid:low.conf
CAACTATATCGAATGC-1	c2:aneuploid:low.conf
CAACTCCAACGTTTAG-1	c2:aneuploid:low.conf
CAACTCCGTAACTTGC-1	c2:aneuploid:low.conf
CAACTCCTTGATCCCG-1	c2:aneuploid:low.conf
CAACTGAGGGTATGAC-1	c2:aneuploid:low.conf
CAACTGCTCATCCGAT-1	c2:aneuploid:low.conf
CAACTTGTAGTGGGCA-1	c2:aneuploid:low.conf
CAAGAAACCCTAAACT-1	c2:aneuploid:low.conf
CAAGACTCAGAAGCGC-1	c2:aneuploid:low.conf
CAAGAGGGCGGAGTAC-1	c2:aneuploid:low.conf
CAAGATATTATAACGT-1	c2:aneuploid:low.conf
CAAGCAACGTCGGAGT-1	c2:aneuploid:low.conf
CAAGCACCAAATGCCT-1	c2:aneuploid:low.conf
CAAGCGGCACATAATT-1	c2:aneuploid:low.conf
CAAGGATCGCATGTTC-1	c2:aneuploid:low.conf
CAAGGCCAGTGGTGCA-1	c1:diploid:low.conf
CAAGGTCCTATAGGCT-1	c2:aneuploid:low.conf
CAAGTAAGTGATAGAC-1	c2:aneuploid:low.conf
CAAGTCGTTGAAATCT-1	c2:aneuploid:low.conf
CAAGTGAACTTTGGTT-1	c2:aneuploid:low.conf
CAAGTGTGGTTGCAAA-1	c2:aneuploid:low.conf
CAATAAACCTTGGCCC-1	c2:aneuploid:low.conf
CAATACGAGAGTCTGA-1	c2:aneuploid:low.conf
CAATATGTAGATTTAC-1	c2:aneuploid:low.conf
CAATATTCTTGACCTA-1	c1:diploid:low.conf
CAATATTGGACTAGTG-1	c2:aneuploid:low.conf
CAATCCCTATACCAGC-1	c2:aneuploid:low.conf
CAATCCTGCCGTGGAG-1	c2:aneuploid:low.conf
CAATGACCCTTAATTT-1	c2:aneuploid:low.conf
CAATGAGGTTCGACTA-1	c2:aneuploid:low.conf
CAATGGAATCTACATA-1	c2:aneuploid:low.conf
CAATGGATCTCTACCA-1	c2:aneuploid:low.conf
CAATGGTCGGCCTGGG-1	c2:aneuploid:low.conf
CAATGTGCCAACCCTT-1	c2:aneuploid:low.conf
CAATTAAGGGTGATGA-1	c2:aneuploid:low.conf
CAATTTCGTATAAGGG-1	c2:aneuploid:low.conf
CACAAACCGCAGAACT-1	c1:diploid:low.conf
CACAAGAAAGATATTA-1	c2:aneuploid:low.conf
CACAATGAGCTGCTAT-1	c2:aneuploid:low.conf
CACACACGCTAACGAG-1	c2:aneuploid:low.conf
CACACAGCTTGCGCTC-1	c2:aneuploid:low.conf
CACACAGGGATAGATT-1	c2:aneuploid:low.conf
CACACGCGCTGTCTTA-1	c2:aneuploid:low.conf
CACACGTTTCAATGGG-1	c2:aneuploid:low.conf
CACACTTGTATTGCGA-1	c2:aneuploid:low.conf
CACAGCACCCACGGCA-1	c2:aneuploid:low.conf
CACAGCTAGGGAGTGA-1	c2:aneuploid:low.conf
CACAGGGCCATATAGT-1	c2:aneuploid:low.conf
CACAGGGCCGTTGTCA-1	c2:aneuploid:low.conf
CACAGTTCGCTTCCCA-1	c2:aneuploid:low.conf
CACATATTAGCAGGAT-1	c2:aneuploid:low.conf
CACATCGTGCACGCGC-1	c1:diploid:low.conf
CACATCTCACCGACGA-1	c2:aneuploid:low.conf
CACATGATTCAGCAAC-1	c2:aneuploid:low.conf
CACATGTTTGGACATG-1	c2:aneuploid:low.conf
CACATTCTTTCGATGG-1	c2:aneuploid:low.conf
CACATTTCTTGTCAGA-1	c2:aneuploid:low.conf
CACCATCGGAGGAGAC-1	c2:aneuploid:low.conf
CACCATGATCGCAAAG-1	c2:aneuploid:low.conf
CACCCAAATCTTATGT-1	c2:aneuploid:low.conf
CACCCACACGTCACCC-1	c2:aneuploid:low.conf
CACCCACGAGGCAATT-1	c2:aneuploid:low.conf
CACCCGGTTTGTGACT-1	c1:diploid:low.conf
CACCCTAACAAGATCT-1	c2:aneuploid:low.conf
CACCCTTTCCTCGCTC-1	c2:aneuploid:low.conf
CACCGATACACCGAGC-1	c2:aneuploid:low.conf
CACCGCCAGAAGGTTT-1	c1:diploid:low.conf
CACCGCCGACCAGCGA-1	c2:aneuploid:low.conf
CACCGCGTCCACTCTA-1	c2:aneuploid:low.conf
CACCGGAGATATCTCC-1	c2:aneuploid:low.conf
CACCGTATCCCATCCG-1	c2:aneuploid:low.conf
CACCGTTAGGGATCAC-1	c1:diploid:low.conf
CACCTAATAGAGTCGT-1	c2:aneuploid:low.conf
CACCTAATCAGTTTAC-1	c2:aneuploid:low.conf
CACCTCGATGGTGGAC-1	c2:aneuploid:low.conf
CACCTTGCGAAACTCG-1	c2:aneuploid:low.conf
CACCTTGGCGCCTTTG-1	c2:aneuploid:low.conf
CACGAAAGTTAGTCCC-1	c2:aneuploid:low.conf
CACGACGTAATAGTAA-1	c2:aneuploid:low.conf
CACGACTAAAGTTCTG-1	c2:aneuploid:low.conf
CACGAGCAAACCAGAC-1	c2:aneuploid:low.conf
CACGATTGGTCGTTAA-1	c2:aneuploid:low.conf
CACGCACAGCGCAGCT-1	c2:aneuploid:low.conf
CACGCAGCGAGGCTTT-1	c2:aneuploid:low.conf
CACGCGGAACTGTTGC-1	c2:aneuploid:low.conf
CACGGACGTGGATGGC-1	c2:aneuploid:low.conf
CACGGCGCGCCAAAGG-1	c2:aneuploid:low.conf
CACGTCGGCAACCTCT-1	c1:diploid:low.conf
CACGTCTATGATGTGG-1	c2:aneuploid:low.conf
CACGTTCGTGCTCTAG-1	c2:aneuploid:low.conf
CACGTTTCGTACACAC-1	c2:aneuploid:low.conf
CACTAAAGTTGCCTAT-1	c2:aneuploid:low.conf
CACTACGGGAGCTGCC-1	c2:aneuploid:low.conf
CACTACTCAGTTCTGT-1	c2:aneuploid:low.conf
CACTCAAGAGCTATGG-1	c2:aneuploid:low.conf
CACTCAGCTCTTGAGG-1	c2:aneuploid:low.conf
CACTCCTATGTAAGAT-1	c2:aneuploid:low.conf
CACTCCTCTCGGTCGG-1	c2:aneuploid:low.conf
CACTCGAGCTGAACAA-1	c2:aneuploid:low.conf
CACTCTCAAGCATCGA-1	c2:aneuploid:low.conf
CACTCTTCTGCTAGCC-1	c2:aneuploid:low.conf
CACTGACGATTGTGGA-1	c2:aneuploid:low.conf
CACTGTCCAAGTGAGA-1	c2:aneuploid:low.conf
CACTTAATCAGACGGA-1	c2:aneuploid:low.conf
CACTTCGCCACAGGCT-1	c2:aneuploid:low.conf
CACTTCGTCTTATCTC-1	c2:aneuploid:low.conf
CAGAACTTAGCCCTCT-1	c2:aneuploid:low.conf
CAGAATAACACACGGA-1	c2:aneuploid:low.conf
CAGAATATTCGTTATC-1	c2:aneuploid:low.conf
CAGACACCGATCGCTG-1	c2:aneuploid:low.conf
CAGACCTGTAAGTGTT-1	c2:aneuploid:low.conf
CAGACGAACCTGATAC-1	c2:aneuploid:low.conf
CAGAGACGGTCACCCA-1	c2:aneuploid:low.conf
CAGAGCATGAGCTTGC-1	c2:aneuploid:low.conf
CAGAGGCGATGCATGA-1	c2:aneuploid:low.conf
CAGAGTGATTTAACGT-1	c2:aneuploid:low.conf
CAGATAATGGGCGGGT-1	c1:diploid:low.conf
CAGATATGAAGATGAC-1	c1:diploid:low.conf
CAGATCATTTAAAGTC-1	c2:aneuploid:low.conf
CAGCAGCCCGTTCCTT-1	c2:aneuploid:low.conf
CAGCAGTCCAGACTAT-1	c2:aneuploid:low.conf
CAGCAGTCTGTGCTGC-1	c2:aneuploid:low.conf
CAGCCCTCACAGGCAG-1	c2:aneuploid:low.conf
CAGCCGGGCCCTCTAT-1	c2:aneuploid:low.conf
CAGCCTCCTGCAGAGG-1	c1:diploid:low.conf
CAGCCTCTCCTCAAGA-1	c2:aneuploid:low.conf
CAGCGATTCCCTTCAA-1	c2:aneuploid:low.conf
CAGCTCACTGAGACAT-1	c2:aneuploid:low.conf
CAGCTCGACAAGTTAA-1	c2:aneuploid:low.conf
CAGCTCTGGGCTCACT-1	c2:aneuploid:low.conf
CAGGAAGACTTTATAT-1	c2:aneuploid:low.conf
CAGGACAGCTGCCCTT-1	c2:aneuploid:low.conf
CAGGATATATCGTTGT-1	c2:aneuploid:low.conf
CAGGATCCGCCCGACC-1	c2:aneuploid:low.conf
CAGGCAGTCTTACCAG-1	c2:aneuploid:low.conf
CAGGCCGTTTGGGTGT-1	c2:aneuploid:low.conf
CAGGCGCACGGTGGTC-1	c2:aneuploid:low.conf
CAGGCGCCATGCTAGG-1	c2:aneuploid:low.conf
CAGGGAGATAGGCCAG-1	c2:aneuploid:low.conf
CAGGTTTAGTACTACA-1	c2:aneuploid:low.conf
CAGTAACTATTTATTG-1	c2:aneuploid:low.conf
CAGTAATCCCTCCCAG-1	c2:aneuploid:low.conf
CAGTACATTCTCTAAA-1	c1:diploid:low.conf
CAGTAGCCCACGCGGT-1	c2:aneuploid:low.conf
CAGTCCAACGCCTTCT-1	c2:aneuploid:low.conf
CAGTCGAGGATGCAAT-1	c2:aneuploid:low.conf
CAGTCTCTCGGCTAAT-1	c2:aneuploid:low.conf
CAGTCTGTATACTGGG-1	c2:aneuploid:low.conf
CAGTGAATAAATGACT-1	c2:aneuploid:low.conf
CAGTGGTTGCACATGA-1	c2:aneuploid:low.conf
CAGTGTCCGCAGAATG-1	c2:aneuploid:low.conf
CAGTGTCGGCTGGCCC-1	c2:aneuploid:low.conf
CAGTTCAAATTGACAC-1	c1:diploid:low.conf
CAGTTCCGCGGGTCGA-1	c2:aneuploid:low.conf
CAGTTCGAGGACCCGA-1	c2:aneuploid:low.conf
CATAACGGACAGTCGT-1	c2:aneuploid:low.conf
CATAAGAAGCTTGGCT-1	c2:aneuploid:low.conf
CATAATGAGCGGGCGA-1	c2:aneuploid:low.conf
CATACAAAGCCGAACC-1	c2:aneuploid:low.conf
CATACACGGTTCCCAC-1	c2:aneuploid:low.conf
CATACGAACTAGCTGG-1	c1:diploid:low.conf
CATACGGCGTCTGGGC-1	c2:aneuploid:low.conf
CATACGGGTGCATGAT-1	c2:aneuploid:low.conf
CATACTATGTAATTGT-1	c1:diploid:low.conf
CATACTTAGGCAATAC-1	c2:aneuploid:low.conf
CATACTTCTTTCTCCG-1	c2:aneuploid:low.conf
CATAGAGGAGATACTA-1	c2:aneuploid:low.conf
CATAGCCGCCCGGGAT-1	c2:aneuploid:low.conf
CATAGCGTTGCCCACC-1	c1:diploid:low.conf
CATAGGGACACTTGTG-1	c2:aneuploid:low.conf
CATAGTACATTGAGAG-1	c2:aneuploid:low.conf
CATAGTAGCATAGTAG-1	c2:aneuploid:low.conf
CATAGTCAAATACATA-1	c2:aneuploid:low.conf
CATAGTCCACAAGAAC-1	c2:aneuploid:low.conf
CATATACTACTGATAA-1	c1:diploid:low.conf
CATATAGGTACAGTCA-1	c2:aneuploid:low.conf
CATATTATTTGCCCTA-1	c2:aneuploid:low.conf
CATCAAACTGGCGCCC-1	c2:aneuploid:low.conf
CATCATCTACCCGGAC-1	c2:aneuploid:low.conf
CATCATTACCCTGAGG-1	c2:aneuploid:low.conf
CATCCCGAGATTCATA-1	c1:diploid:low.conf
CATCCGCAGGCCCGAA-1	c2:aneuploid:low.conf
CATCCTCTCAAAGATC-1	c2:aneuploid:low.conf
CATCGAATGGATCTCT-1	c2:aneuploid:low.conf
CATCGGACGGGTTAAT-1	c2:aneuploid:low.conf
CATCTACCCGAGAACG-1	c1:diploid:low.conf
CATCTAGTGAAGGGAA-1	c2:aneuploid:low.conf
CATCTATCCCGTGTCT-1	c1:diploid:low.conf
CATCTTACACCACCTC-1	c2:aneuploid:low.conf
CATGAACCGACATTTG-1	c2:aneuploid:low.conf
CATGAACCTCTTATCA-1	c2:aneuploid:low.conf
CATGACTTCGCTGAAT-1	c2:aneuploid:low.conf
CATGAGATGCACTCTC-1	c2:aneuploid:low.conf
CATGAGTCCATCACGG-1	c2:aneuploid:low.conf
CATGATACGGTGAAAC-1	c2:aneuploid:low.conf
CATGATGCACAATTCT-1	c2:aneuploid:low.conf
CATGATGGAAGTTAGC-1	c2:aneuploid:low.conf
CATGCACATGAGAGGC-1	c2:aneuploid:low.conf
CATGCACGTGTTACTG-1	c2:aneuploid:low.conf
CATGCATGGAGACCCT-1	c2:aneuploid:low.conf
CATGCGACCAGTTTAA-1	c2:aneuploid:low.conf
CATGCGTTAGACAGAA-1	c2:aneuploid:low.conf
CATGCGTTGAGAGGAG-1	c2:aneuploid:low.conf
CATGCTGGCTCCAATT-1	c2:aneuploid:low.conf
CATGGAAATGGGACCA-1	c2:aneuploid:low.conf
CATGGATTGTCTTCCG-1	c2:aneuploid:low.conf
CATGGCAGGAAGATCG-1	c2:aneuploid:low.conf
CATGGGTATGCCTTAT-1	c2:aneuploid:low.conf
CATGGGTCGGGTGTGG-1	c2:aneuploid:low.conf
CATGGTAAGTAGCGTT-1	c2:aneuploid:low.conf
CATGGTCTAGATACCG-1	c2:aneuploid:low.conf
CATGGTTTATTAATCA-1	c1:diploid:low.conf
CATGTAAGAGACATTT-1	c2:aneuploid:low.conf
CATGTAGGAGCGCCAA-1	c2:aneuploid:low.conf
CATGTCTCATTTATGG-1	c2:aneuploid:low.conf
CATTACATAGATTGTG-1	c2:aneuploid:low.conf
CATTACGCAGGAAGGG-1	c2:aneuploid:low.conf
CATTACGTCGGCCCGT-1	c2:aneuploid:low.conf
CATTATAACAGGGTCC-1	c2:aneuploid:low.conf
CATTATCCCATTAACG-1	c2:aneuploid:low.conf
CATTATGCTTGTTGTG-1	c2:aneuploid:low.conf
CATTCACTGACAGCTA-1	c1:diploid:low.conf
CATTCCCATTCCGTCG-1	c1:diploid:low.conf
CATTCCCTAAGTACAA-1	c2:aneuploid:low.conf
CATTGATGAACACGCC-1	c2:aneuploid:low.conf
CATTGCGGGTCAATTC-1	c2:aneuploid:low.conf
CATTGTGTGCTAGATC-1	c2:aneuploid:low.conf
CATTTAGCGGACCATG-1	c2:aneuploid:low.conf
CATTTATCGTTCAAGA-1	c2:aneuploid:low.conf
CATTTCTAGCAGACTA-1	c2:aneuploid:low.conf
CATTTGAGTGGTACGT-1	c2:aneuploid:low.conf
CCAAACAGAACCCTCG-1	c2:aneuploid:low.conf
CCAAAGTCCCGCTAAC-1	c2:aneuploid:low.conf
CCAAATAACAAGATTC-1	c2:aneuploid:low.conf
CCAAATCAAAGGGCAA-1	c2:aneuploid:low.conf
CCAACCTTATGTAACT-1	c2:aneuploid:low.conf
CCAACGATGCACTGAT-1	c2:aneuploid:low.conf
CCAACGCTTGCCAGGG-1	c2:aneuploid:low.conf
CCAACTTGATAGATCC-1	c2:aneuploid:low.conf
CCAAGAAAGTGGGCGA-1	c2:aneuploid:low.conf
CCAAGACTTCTGCGAA-1	c2:aneuploid:low.conf
CCAAGCGTAACTCGTA-1	c2:aneuploid:low.conf
CCAAGGAACAGAGAGG-1	c2:aneuploid:low.conf
CCAAGGTTGCCCTTTC-1	c1:diploid:low.conf
CCAATAGTGCCGTCGA-1	c2:aneuploid:low.conf
CCAATCGGTAGATCGA-1	c2:aneuploid:low.conf
CCAATGTCACAGCAAG-1	c1:diploid:low.conf
CCAATTACGGGTCGAG-1	c2:aneuploid:low.conf
CCACAATGTACGTCTT-1	c2:aneuploid:low.conf
CCACACTGAGATATTA-1	c2:aneuploid:low.conf
CCACAGCTGAAATCAT-1	c2:aneuploid:low.conf
CCACAGTACCCATCCT-1	c2:aneuploid:low.conf
CCACATACTGCACCCA-1	c2:aneuploid:low.conf
CCACCAACTTTACTGT-1	c2:aneuploid:low.conf
CCACCCAAGGAAAGTG-1	c1:diploid:low.conf
CCACGAATTTAACCTC-1	c2:aneuploid:low.conf
CCACGAGAAGAGAATC-1	c2:aneuploid:low.conf
CCACGGCAGGTGTAGG-1	c2:aneuploid:low.conf
CCACGGTGCCCGGTAG-1	c1:diploid:low.conf
CCACGTAAATTAGACT-1	c2:aneuploid:low.conf
CCACTATCCGGGTCAC-1	c2:aneuploid:low.conf
CCACTCAGATCCGCAA-1	c2:aneuploid:low.conf
CCACTGTTTGGATTAA-1	c2:aneuploid:low.conf
CCAGAAACTGATGCGA-1	c1:diploid:low.conf
CCAGAAAGCAACTCAT-1	c1:diploid:low.conf
CCAGAGACAAAGCCGG-1	c2:aneuploid:low.conf
CCAGATAGTTGAGTGA-1	c2:aneuploid:low.conf
CCAGATGTAAATGGGT-1	c2:aneuploid:low.conf
CCAGCCTGGACCAATA-1	c2:aneuploid:low.conf
CCAGCGGGATCACCAG-1	c2:aneuploid:low.conf
CCAGCTACGCCTCATA-1	c2:aneuploid:low.conf
CCAGCTCGAACGCATT-1	c2:aneuploid:low.conf
CCAGGGACGTGGCCTC-1	c2:aneuploid:low.conf
CCAGTAGTCTGATCCA-1	c2:aneuploid:low.conf
CCAGTCCATTATTCGA-1	c2:aneuploid:low.conf
CCAGTCTAGACGGCGC-1	c2:aneuploid:low.conf
CCAGTCTTGTCATAGA-1	c2:aneuploid:low.conf
CCATAAACAACCCGAC-1	c2:aneuploid:low.conf
CCATACCTTTACTTGT-1	c2:aneuploid:low.conf
CCATAGGTTGGCGTGG-1	c2:aneuploid:low.conf
CCATAGTCAGTAACCC-1	c2:aneuploid:low.conf
CCATATGGAAACTATA-1	c2:aneuploid:low.conf
CCATATTGGATCATGA-1	c2:aneuploid:low.conf
CCATCCATACCAAGTC-1	c2:aneuploid:low.conf
CCATCGCAGTTAAACT-1	c2:aneuploid:low.conf
CCATCTCACCAGTGAA-1	c2:aneuploid:low.conf
CCATCTTGTTCACAAT-1	c2:aneuploid:low.conf
CCATGCCCTAGATTTC-1	c2:aneuploid:low.conf
CCATGCCTGTTTAGTA-1	c2:aneuploid:low.conf
CCATGGCAAACGCTCA-1	c2:aneuploid:low.conf
CCATGTTCATCTATAT-1	c2:aneuploid:low.conf
CCATTAGCGATAATCC-1	c2:aneuploid:low.conf
CCATTCCCTGCCCACA-1	c2:aneuploid:low.conf
CCATTGTTTCCTCCAT-1	c2:aneuploid:low.conf
CCATTTCTACCTATTA-1	c2:aneuploid:low.conf
CCCAAACATGCTGCTC-1	c2:aneuploid:low.conf
CCCAACCACACTAACA-1	c2:aneuploid:low.conf
CCCAAGAATGCACGGT-1	c2:aneuploid:low.conf
CCCAAGACAGAGTATG-1	c2:aneuploid:low.conf
CCCAAGTCATTACACT-1	c2:aneuploid:low.conf
CCCAATGAGATTTGCA-1	c1:diploid:low.conf
CCCAGAGGAGGGCGTA-1	c2:aneuploid:low.conf
CCCAGATTCCCGTGAC-1	c2:aneuploid:low.conf
CCCAGGAAGAATTCGA-1	c2:aneuploid:low.conf
CCCAGGTCTGAAGGCT-1	c2:aneuploid:low.conf
CCCAGTTAAGGCGCCG-1	c2:aneuploid:low.conf
CCCGACCATAGTCCGC-1	c2:aneuploid:low.conf
CCCGAGTTTCTCCGTA-1	c2:aneuploid:low.conf
CCCGATAGCCTCGCCT-1	c2:aneuploid:low.conf
CCCGCAAATAATCATC-1	c1:diploid:low.conf
CCCGCAGCGCGAACTA-1	c2:aneuploid:low.conf
CCCGCAGGGCCCAAAG-1	c2:aneuploid:low.conf
CCCGCCATGCTCCCGT-1	c2:aneuploid:low.conf
CCCGCGCAATGCACCC-1	c2:aneuploid:low.conf
CCCGCTTGCCCTCGTC-1	c2:aneuploid:low.conf
CCCGGGTCGTTCAGGG-1	c2:aneuploid:low.conf
CCCGGTGGAAGAACCT-1	c1:diploid:low.conf
CCCGTAGCTGGGAAGA-1	c2:aneuploid:low.conf
CCCGTCAGCGTCTGAC-1	c2:aneuploid:low.conf
CCCGTTTCGCAGATGT-1	c2:aneuploid:low.conf
CCCTACCCACACCCAG-1	c2:aneuploid:low.conf
CCCTACTTGAACAATG-1	c2:aneuploid:low.conf
CCCTAGCTCTAAGGTC-1	c1:diploid:low.conf
CCCTCAGATCGAGAAC-1	c2:aneuploid:low.conf
CCCTCATCACAGAGTA-1	c2:aneuploid:low.conf
CCCTCATTCTGGAATT-1	c2:aneuploid:low.conf
CCCTCCTCGCTCGTAT-1	c2:aneuploid:low.conf
CCCTCGATAATACACA-1	c2:aneuploid:low.conf
CCCTCGGGAGCCTTGT-1	c2:aneuploid:low.conf
CCCTGAAATGAGTTGA-1	c2:aneuploid:low.conf
CCCTGATGTAACTCGT-1	c2:aneuploid:low.conf
CCCTGGGAGGGATCCT-1	c1:diploid:low.conf
CCCTGGTATGGGCGGC-1	c2:aneuploid:low.conf
CCCTTCTCGTACGCGA-1	c2:aneuploid:low.conf
CCCTTTGACAGGTCTT-1	c2:aneuploid:low.conf
CCGAAAGTGGTGAGCA-1	c2:aneuploid:low.conf
CCGAACCTTCCCGGCC-1	c2:aneuploid:low.conf
CCGAAGGGCGTACCGC-1	c2:aneuploid:low.conf
CCGAAGTATATTGTTC-1	c2:aneuploid:low.conf
CCGACAAACACATGAG-1	c2:aneuploid:low.conf
CCGACAATAGGCCGCC-1	c2:aneuploid:low.conf
CCGACGGGCATGAGGT-1	c2:aneuploid:low.conf
CCGACGTAAACACAAC-1	c2:aneuploid:low.conf
CCGACTCGCATAGTCT-1	c2:aneuploid:low.conf
CCGAGAAGTCGCATAA-1	c2:aneuploid:low.conf
CCGAGCTGTGCTTGTC-1	c2:aneuploid:low.conf
CCGAGGGATGTTAGGC-1	c2:aneuploid:low.conf
CCGATCTCAACCTTAT-1	c2:aneuploid:low.conf
CCGATCTTAAGAGGCT-1	c2:aneuploid:low.conf
CCGCACAAAGACCAAC-1	c1:diploid:low.conf
CCGCACACGAACGTGT-1	c1:diploid:low.conf
CCGCACGTGACCTCGG-1	c2:aneuploid:low.conf
CCGCACTTGCAATGAC-1	c1:diploid:low.conf
CCGCATGTGGTACGAT-1	c2:aneuploid:low.conf
CCGCCACCACAATCCA-1	c2:aneuploid:low.conf
CCGCCGGTCAACACAC-1	c2:aneuploid:low.conf
CCGCCGTTGAGGATAA-1	c2:aneuploid:low.conf
CCGCCTGCGAATTGGT-1	c2:aneuploid:low.conf
CCGCGGAATGCGTCAC-1	c2:aneuploid:low.conf
CCGCTATCAGCACCAG-1	c1:diploid:low.conf
CCGCTCCAGGGCGATC-1	c2:aneuploid:low.conf
CCGCTCTTCCGAACTA-1	c1:diploid:low.conf
CCGCTGGTGCCATTCA-1	c2:aneuploid:low.conf
CCGCTTACCTCACTCT-1	c2:aneuploid:low.conf
CCGCTTCGCGGTTAAC-1	c2:aneuploid:low.conf
CCGCTTGCTGACATGG-1	c2:aneuploid:low.conf
CCGGAAGTTATCAGTC-1	c2:aneuploid:low.conf
CCGGAATGGTTTCAGT-1	c2:aneuploid:low.conf
CCGGAGCGTACTTTCT-1	c2:aneuploid:low.conf
CCGGAGGTCTTATGGT-1	c2:aneuploid:low.conf
CCGGCACGACCGTTTC-1	c2:aneuploid:low.conf
CCGGCGCATATTGGAT-1	c2:aneuploid:low.conf
CCGGGACCCGCAGAGA-1	c2:aneuploid:low.conf
CCGGGCGGTCTCGTCA-1	c2:aneuploid:low.conf
CCGGGCTAAGAATTTC-1	c1:diploid:low.conf
CCGGGCTGCTCCATAC-1	c2:aneuploid:low.conf
CCGGTAATGGCTAGTC-1	c2:aneuploid:low.conf
CCGGTTTGTAATTGTG-1	c1:diploid:low.conf
CCGTAAGTTGGTCCCA-1	c2:aneuploid:low.conf
CCGTACCCAAGCGCCA-1	c2:aneuploid:low.conf
CCGTAGGAAATCCCTG-1	c2:aneuploid:low.conf
CCGTAGGGTTGTTTAC-1	c2:aneuploid:low.conf
CCGTATCTCGTCGTAG-1	c2:aneuploid:low.conf
CCGTATTAGCGCAGTT-1	c2:aneuploid:low.conf
CCGTGAGGCATTCATG-1	c1:diploid:low.conf
CCGTGCCCATGACGGC-1	c2:aneuploid:low.conf
CCGTGGAACGATCCAA-1	c1:diploid:low.conf
CCGTGTTAAATTCCAT-1	c1:diploid:low.conf
CCGTTACGTTAGAACA-1	c2:aneuploid:low.conf
CCGTTTCCTTTCCGTG-1	c2:aneuploid:low.conf
CCTAAACAGGGTCCGT-1	c2:aneuploid:low.conf
CCTAAAGGCTGACGCT-1	c2:aneuploid:low.conf
CCTAAATTAACGGTTC-1	c2:aneuploid:low.conf
CCTAAATTGTATCCTA-1	c2:aneuploid:low.conf
CCTAACCCAAACAAGT-1	c2:aneuploid:low.conf
CCTAACTAAGGCTCTA-1	c2:aneuploid:low.conf
CCTACAAGTCCGGAAT-1	c2:aneuploid:low.conf
CCTACATTCACAGACG-1	c2:aneuploid:low.conf
CCTACGCGACCTTACA-1	c2:aneuploid:low.conf
CCTACGGCTCAGTCGA-1	c2:aneuploid:low.conf
CCTACTGCGGCGGCCA-1	c2:aneuploid:low.conf
CCTACTGCTTACACTT-1	c1:diploid:low.conf
CCTAGGCGTAGCGATC-1	c2:aneuploid:low.conf
CCTAGTTAGTCGCATG-1	c2:aneuploid:low.conf
CCTATAATGAGTGCCC-1	c2:aneuploid:low.conf
CCTATACCGTCCTGTC-1	c1:diploid:low.conf
CCTATATTTGTCCTGG-1	c2:aneuploid:low.conf
CCTATCTATATCGGAA-1	c2:aneuploid:low.conf
CCTATGAAGTGGTGCC-1	c2:aneuploid:low.conf
CCTATGGGTTACCGTC-1	c2:aneuploid:low.conf
CCTATGGTCAAAGCTG-1	c2:aneuploid:low.conf
CCTATGTCCACTCCAC-1	c1:diploid:low.conf
CCTCACCAATCTTGAC-1	c2:aneuploid:low.conf
CCTCACCTGAGGGAGC-1	c2:aneuploid:low.conf
CCTCACCTTAGCATCG-1	c2:aneuploid:low.conf
CCTCATGCAGCTACGA-1	c2:aneuploid:low.conf
CCTCCCGACAATCCCT-1	c2:aneuploid:low.conf
CCTCCGACAATTCAAG-1	c2:aneuploid:low.conf
CCTCCTGTTGTGTCGT-1	c1:diploid:low.conf
CCTCGAAGTGGACGGG-1	c2:aneuploid:low.conf
CCTCGACCCACTGCCT-1	c1:diploid:low.conf
CCTCGCCAGCAAATTA-1	c2:aneuploid:low.conf
CCTCGCGCGATATAGG-1	c2:aneuploid:low.conf
CCTCGCGCTGTGCGAT-1	c2:aneuploid:low.conf
CCTCGGACCGGGATAG-1	c2:aneuploid:low.conf
CCTCGGTTTCCTTGCC-1	c2:aneuploid:low.conf
CCTCGTTACGCCTGTT-1	c2:aneuploid:low.conf
CCTCTAATCTGCCAAG-1	c2:aneuploid:low.conf
CCTCTACAAGGATTGG-1	c1:diploid:low.conf
CCTCTCTCCCATCTAG-1	c2:aneuploid:low.conf
CCTCTGGCCTAGACGG-1	c2:aneuploid:low.conf
CCTCTGTACTATTCTA-1	c2:aneuploid:low.conf
CCTGAACGATATATTC-1	c2:aneuploid:low.conf
CCTGAATATTTACATA-1	c2:aneuploid:low.conf
CCTGACCACCGATGGT-1	c2:aneuploid:low.conf
CCTGACGCAACCTTTA-1	c2:aneuploid:low.conf
CCTGAGAATAAATGCA-1	c2:aneuploid:low.conf
CCTGCTATTTGAGAAG-1	c2:aneuploid:low.conf
CCTGGAAACGTTCTGC-1	c2:aneuploid:low.conf
CCTGGCTAGACCCGCC-1	c2:aneuploid:low.conf
CCTGGTCGAATGTGGG-1	c2:aneuploid:low.conf
CCTGTAAGACATGATA-1	c2:aneuploid:low.conf
CCTGTCACCCGGGCTC-1	c2:aneuploid:low.conf
CCTGTCCCTCACGTTA-1	c2:aneuploid:low.conf
CCTGTCGCCCGTAAAT-1	c2:aneuploid:low.conf
CCTGTGCATAGGAGAC-1	c2:aneuploid:low.conf
CCTGTTCAACCTCGGG-1	c2:aneuploid:low.conf
CCTGTTTGAAGACACG-1	c2:aneuploid:low.conf
CCTTCAGTTAAAGTGA-1	c2:aneuploid:low.conf
CCTTCGTATAGAATCC-1	c2:aneuploid:low.conf
CCTTCTTGATCCAGTG-1	c2:aneuploid:low.conf
CCTTGACCACTTTATT-1	c2:aneuploid:low.conf
CCTTGTGAACGTGGTT-1	c2:aneuploid:low.conf
CCTTTAAGGGAGCACT-1	c2:aneuploid:low.conf
CCTTTCAATGAAGAAA-1	c2:aneuploid:low.conf
CGAAACATAGATGGCA-1	c2:aneuploid:low.conf
CGAACAGTATGGGCGT-1	c2:aneuploid:low.conf
CGAACATAGTCAGAAA-1	c2:aneuploid:low.conf
CGAACCCGCATGCGTC-1	c2:aneuploid:low.conf
CGAACCTCTTTCCTAG-1	c2:aneuploid:low.conf
CGAACGCCCAGTGCCG-1	c2:aneuploid:low.conf
CGAAGACTGCCCGGGA-1	c2:aneuploid:low.conf
CGAAGATCAGTTTCAT-1	c2:aneuploid:low.conf
CGAAGCTATAAATTCA-1	c2:aneuploid:low.conf
CGAAGTTGCTCTGTGT-1	c2:aneuploid:low.conf
CGAATGACGCATAATG-1	c2:aneuploid:low.conf
CGAATGGTAGGTCGTC-1	c2:aneuploid:low.conf
CGACAATTTGATCTAA-1	c2:aneuploid:low.conf
CGACACCGCTTAAGGA-1	c2:aneuploid:low.conf
CGACACGCTCCGACAG-1	c2:aneuploid:low.conf
CGACACGGATGCCCAC-1	c2:aneuploid:low.conf
CGACAGTTCGCGTTAT-1	c2:aneuploid:low.conf
CGACATGCGATCTTCT-1	c2:aneuploid:low.conf
CGACCGTTGGTATTCG-1	c2:aneuploid:low.conf
CGACTCAGGATGTTAT-1	c2:aneuploid:low.conf
CGACTCGGTACACGGT-1	c2:aneuploid:low.conf
CGACTTGCCGGGAAAT-1	c1:diploid:low.conf
CGACTTTGTATAGCCT-1	c2:aneuploid:low.conf
CGAGACCCTAGAGTGT-1	c2:aneuploid:low.conf
CGAGAGATGTGAACCT-1	c2:aneuploid:low.conf
CGAGAGCTTTCACTAC-1	c1:diploid:low.conf
CGAGAGGGTAGCCGCG-1	c2:aneuploid:low.conf
CGAGATGTTGCCTATA-1	c2:aneuploid:low.conf
CGAGATTTCGCTCGGG-1	c1:diploid:low.conf
CGAGCACTTCAAGTTT-1	c2:aneuploid:low.conf
CGAGCGTTGATCAGCC-1	c2:aneuploid:low.conf
CGAGCTGGGCTTTAGG-1	c2:aneuploid:low.conf
CGAGGAGCTTCCATAT-1	c2:aneuploid:low.conf
CGAGGATCGGGAACGA-1	c2:aneuploid:low.conf
CGAGGCCAGGCATTGG-1	c2:aneuploid:low.conf
CGAGGCTAAATATGGC-1	c2:aneuploid:low.conf
CGAGGGACTGCGGTCG-1	c2:aneuploid:low.conf
CGAGGGTATCCAGGTG-1	c2:aneuploid:low.conf
CGAGTACTAAAGAGGA-1	c2:aneuploid:low.conf
CGAGTGAAGGTACCAG-1	c2:aneuploid:low.conf
CGAGTGCTATAGTTCG-1	c2:aneuploid:low.conf
CGAGTTCTGTCCCACC-1	c2:aneuploid:low.conf
CGAGTTTATCGGACTG-1	c2:aneuploid:low.conf
CGATAACCAATTTGAG-1	c2:aneuploid:low.conf
CGATAATACTCAGGTT-1	c1:diploid:low.conf
CGATACCTCGCGGACA-1	c2:aneuploid:low.conf
CGATAGTCGTACTGCA-1	c2:aneuploid:low.conf
CGATATTAGCCGCAGG-1	c2:aneuploid:low.conf
CGATCATTAGAGGCAC-1	c2:aneuploid:low.conf
CGATCCACCATTGTTG-1	c2:aneuploid:low.conf
CGATCCGACCCAGTGC-1	c2:aneuploid:low.conf
CGATCCTCGCAACATA-1	c2:aneuploid:low.conf
CGATCGAGAAGCACCA-1	c2:aneuploid:low.conf
CGATGGACCCTACGCC-1	c2:aneuploid:low.conf
CGATTAAATATCTCCT-1	c2:aneuploid:low.conf
CGATTCGCCTGGCTGC-1	c2:aneuploid:low.conf
CGATTTGTCATTAATG-1	c2:aneuploid:low.conf
CGCAAACACGAGTTAC-1	c2:aneuploid:low.conf
CGCAATTACTTTCGGT-1	c2:aneuploid:low.conf
CGCAATTAGGGTAATA-1	c2:aneuploid:low.conf
CGCAATTCTACAATAA-1	c2:aneuploid:low.conf
CGCACATGTCCACTAC-1	c2:aneuploid:low.conf
CGCACGTCTGTTTATG-1	c2:aneuploid:low.conf
CGCACGTGCGCTATCA-1	c2:aneuploid:low.conf
CGCAGAAACATTTGCG-1	c2:aneuploid:low.conf
CGCAGATCTTCACCCG-1	c2:aneuploid:low.conf
CGCAGGCGATCCAAAC-1	c2:aneuploid:low.conf
CGCATCATGGCTTCAG-1	c2:aneuploid:low.conf
CGCATCCATCAGCCAG-1	c2:aneuploid:low.conf
CGCATGCCGAATGCGT-1	c2:aneuploid:low.conf
CGCATGGTGCGATGCT-1	c2:aneuploid:low.conf
CGCATTAGCTAATAGG-1	c2:aneuploid:low.conf
CGCCACCCGCATTAAC-1	c2:aneuploid:low.conf
CGCCATCCGATTATGA-1	c2:aneuploid:low.conf
CGCCCAGCACGCCTAG-1	c2:aneuploid:low.conf
CGCCCAGCGTTTCACG-1	c2:aneuploid:low.conf
CGCCCGCTTCCGTACA-1	c2:aneuploid:low.conf
CGCCCTTGAAGGCTGA-1	c2:aneuploid:low.conf
CGCCGCCCATGCCTGT-1	c2:aneuploid:low.conf
CGCCGCGTTCTGAACG-1	c2:aneuploid:low.conf
CGCCGGTGTCGCAGTA-1	c2:aneuploid:low.conf
CGCCGTCTACCCATCG-1	c1:diploid:low.conf
CGCCGTTCAGCATAGT-1	c2:aneuploid:low.conf
CGCCTCCCTCCTCTAT-1	c2:aneuploid:low.conf
CGCCTTTAGCATGCTC-1	c2:aneuploid:low.conf
CGCGAAGTGGCATACT-1	c1:diploid:low.conf
CGCGACCGCGACAGAT-1	c2:aneuploid:low.conf
CGCGAGAGGGACTTGT-1	c2:aneuploid:low.conf
CGCGCATGTTTGATTG-1	c2:aneuploid:low.conf
CGCGCCCGACTTAATA-1	c2:aneuploid:low.conf
CGCGGCAGTATTACGG-1	c2:aneuploid:low.conf
CGCGGCTCAACTTGAA-1	c2:aneuploid:low.conf
CGCGGGAATTAGGCAG-1	c2:aneuploid:low.conf
CGCGGTAAGTCTAGCT-1	c2:aneuploid:low.conf
CGCGGTCACAAACCAA-1	c2:aneuploid:low.conf
CGCGTACATTCTGGAA-1	c2:aneuploid:low.conf
CGCGTCATATTAAACC-1	c2:aneuploid:low.conf
CGCGTTCATGAAATAC-1	c2:aneuploid:low.conf
CGCTACCGCCCTATGA-1	c2:aneuploid:low.conf
CGCTACGGGACATTTA-1	c2:aneuploid:low.conf
CGCTAGAGACCGCTGC-1	c2:aneuploid:low.conf
CGCTATACCGCCCACT-1	c2:aneuploid:low.conf
CGCTATTCAATGTATG-1	c2:aneuploid:low.conf
CGCTATTCTTAGGCTC-1	c2:aneuploid:low.conf
CGCTCTCCGTAGATTA-1	c2:aneuploid:low.conf
CGCTGAGGACGTCCAA-1	c2:aneuploid:low.conf
CGCTGGTGACTACCCT-1	c2:aneuploid:low.conf
CGCTGTGTGGATGTTG-1	c2:aneuploid:low.conf
CGCTTAGTATTGATAC-1	c2:aneuploid:low.conf
CGCTTCCACTGAAATC-1	c2:aneuploid:low.conf
CGCTTCGGTCTAAGAC-1	c1:diploid:low.conf
CGCTTTCATACCGGTG-1	c2:aneuploid:low.conf
CGCTTTCCGCCAAGGT-1	c2:aneuploid:low.conf
CGCTTTCTTGCATTCG-1	c2:aneuploid:low.conf
CGGAAAGAATCAAACG-1	c2:aneuploid:low.conf
CGGAAATTTCACATCC-1	c2:aneuploid:low.conf
CGGAACGTAAACATAG-1	c2:aneuploid:low.conf
CGGACCTCTGTAGTTA-1	c1:diploid:low.conf
CGGACCTTTACGTCCC-1	c2:aneuploid:low.conf
CGGAGCAATTTAATCG-1	c2:aneuploid:low.conf
CGGAGCATGGCGATCC-1	c2:aneuploid:low.conf
CGGAGCTTATAACACC-1	c2:aneuploid:low.conf
CGGAGTTTGAGAGACA-1	c2:aneuploid:low.conf
CGGATAAGCGGACATG-1	c2:aneuploid:low.conf
CGGATCCTCAAGGACT-1	c2:aneuploid:low.conf
CGGATGAATGCTGTGA-1	c1:diploid:low.conf
CGGATTCTGCCTTATG-1	c2:aneuploid:low.conf
CGGCAAACATCGTGCG-1	c2:aneuploid:low.conf
CGGCAATAAGATCGCC-1	c2:aneuploid:low.conf
CGGCACCGTTAGCGCC-1	c2:aneuploid:low.conf
CGGCACTCAAGAAAGT-1	c2:aneuploid:low.conf
CGGCAGGGTCGGGTTG-1	c2:aneuploid:low.conf
CGGCCACGCACAAAGT-1	c2:aneuploid:low.conf
CGGCCAGAGCGACCAT-1	c2:aneuploid:low.conf
CGGCCCAACCTGTAGT-1	c2:aneuploid:low.conf
CGGCCCAGGTATATCC-1	c2:aneuploid:low.conf
CGGCGCCATCAATCCC-1	c2:aneuploid:low.conf
CGGCTCTAAAGCTGCA-1	c2:aneuploid:low.conf
CGGCTCTTCGTCGAAC-1	c2:aneuploid:low.conf
CGGCTGCAAGATTAAG-1	c2:aneuploid:low.conf
CGGCTTTGTATGATAA-1	c2:aneuploid:low.conf
CGGGAATATAGTATAC-1	c2:aneuploid:low.conf
CGGGAATTTATGTAAA-1	c2:aneuploid:low.conf
CGGGAGCTTCAGTGTA-1	c2:aneuploid:low.conf
CGGGAGTATACCGCCG-1	c2:aneuploid:low.conf
CGGGATCAATGTAAGA-1	c2:aneuploid:low.conf
CGGGCAGCTAAACCGC-1	c2:aneuploid:low.conf
CGGGCCATAGCCGCAC-1	c2:aneuploid:low.conf
CGGGCCTTCTTTGTAA-1	c2:aneuploid:low.conf
CGGGCGATGGATCACG-1	c2:aneuploid:low.conf
CGGGCTACTTAAATTG-1	c2:aneuploid:low.conf
CGGGTGTACCCATTTA-1	c2:aneuploid:low.conf
CGGGTTCGGCACGTAT-1	c2:aneuploid:low.conf
CGGGTTTGTTAGGGCT-1	c2:aneuploid:low.conf
CGGTACTAGAATCAAA-1	c2:aneuploid:low.conf
CGGTAGAGGTGCAGGT-1	c2:aneuploid:low.conf
CGGTATAGGTATTAGC-1	c2:aneuploid:low.conf
CGGTATGGGCACTCTG-1	c2:aneuploid:low.conf
CGGTCAAGTGGGAACC-1	c2:aneuploid:low.conf
CGGTCCATGAGACTCC-1	c2:aneuploid:low.conf
CGGTCCGTCGCAAGCC-1	c2:aneuploid:low.conf
CGGTCTATCAACCCGT-1	c2:aneuploid:low.conf
CGGTGCGCGTTGGTCC-1	c1:diploid:low.conf
CGGTGGGCTCCAGCCT-1	c2:aneuploid:low.conf
CGGTGTACTTGATCCC-1	c2:aneuploid:low.conf
CGGTTATCCAACAGTG-1	c2:aneuploid:low.conf
CGGTTCAAGTAGGTGT-1	c2:aneuploid:low.conf
CGGTTCCGGCTTCTTG-1	c2:aneuploid:low.conf
CGGTTGAGTATCCTTC-1	c1:diploid:low.conf
CGGTTGGGCAGGGTCC-1	c2:aneuploid:low.conf
CGGTTGGGTTCAAGTT-1	c2:aneuploid:low.conf
CGGTTTATGAAGGAAC-1	c2:aneuploid:low.conf
CGTAAACGCTTGAGTG-1	c2:aneuploid:low.conf
CGTAAAGCAAGAAATC-1	c2:aneuploid:low.conf
CGTAAATAACAAAGGG-1	c2:aneuploid:low.conf
CGTAACTTCGACACTT-1	c2:aneuploid:low.conf
CGTACCGAAAGTCTAG-1	c2:aneuploid:low.conf
CGTACCTGATAGGCCT-1	c2:aneuploid:low.conf
CGTAGAGAGTAATTAT-1	c2:aneuploid:low.conf
CGTAGCGAATTGTCAG-1	c2:aneuploid:low.conf
CGTAGCGCCGACGTTG-1	c2:aneuploid:low.conf
CGTATTAAGAGATCTA-1	c2:aneuploid:low.conf
CGTATTGTTTCCTAAT-1	c2:aneuploid:low.conf
CGTCAAATGGTCGCAG-1	c2:aneuploid:low.conf
CGTCACGTCCATTGGT-1	c2:aneuploid:low.conf
CGTCAGTGCGCACAAG-1	c2:aneuploid:low.conf
CGTCAGTTTATCGTCT-1	c2:aneuploid:low.conf
CGTCATACCATATCCA-1	c2:aneuploid:low.conf
CGTCCTCATCGCGTGC-1	c1:diploid:low.conf
CGTCGCATGTGAGCCA-1	c2:aneuploid:low.conf
CGTCGCGGCGGGATTT-1	c2:aneuploid:low.conf
CGTCGGATAGTGTTGA-1	c2:aneuploid:low.conf
CGTCGTCCTTCGCGAA-1	c2:aneuploid:low.conf
CGTCTCTCGCCGAGGC-1	c2:aneuploid:low.conf
CGTCTGGAAGGGCCCG-1	c2:aneuploid:low.conf
CGTCTTGAGTGTGACG-1	c2:aneuploid:low.conf
CGTGAAGTTAATTCAC-1	c2:aneuploid:low.conf
CGTGACATTGGGTCGT-1	c2:aneuploid:low.conf
CGTGACCAGTCCTCTG-1	c2:aneuploid:low.conf
CGTGCAGACTGGGACA-1	c2:aneuploid:low.conf
CGTGCCCGACATTTGT-1	c2:aneuploid:low.conf
CGTGCCCTCCCGAAGA-1	c2:aneuploid:low.conf
CGTGCTGGCCTAGTCG-1	c2:aneuploid:low.conf
CGTGGAAGCCTCGTAC-1	c2:aneuploid:low.conf
CGTGGCCGAATATCTA-1	c2:aneuploid:low.conf
CGTGGTACCCAAAGGC-1	c2:aneuploid:low.conf
CGTGTATGGGAGCTGA-1	c1:diploid:low.conf
CGTGTCCCATTCGCGA-1	c2:aneuploid:low.conf
CGTGTCTCGTTACGAC-1	c1:diploid:low.conf
CGTGTGTTAAACCCTG-1	c2:aneuploid:low.conf
CGTTAAACTAGTTAGG-1	c2:aneuploid:low.conf
CGTTAATGTCCCGACG-1	c2:aneuploid:low.conf
CGTTAGCTCACAACTG-1	c2:aneuploid:low.conf
CGTTCAAGGAAACGGA-1	c2:aneuploid:low.conf
CGTTCAGACCCGCGAA-1	c2:aneuploid:low.conf
CGTTCTTCGCACACCT-1	c2:aneuploid:low.conf
CGTTGAATACCGCGCT-1	c2:aneuploid:low.conf
CGTTGAGCGACCGTCG-1	c2:aneuploid:low.conf
CGTTGAGTAATTGCGT-1	c2:aneuploid:low.conf
CGTTGCCCGCGTGGGA-1	c2:aneuploid:low.conf
CGTTGTAAACGTCAGG-1	c2:aneuploid:low.conf
CGTTGTAAGATTGATT-1	c1:diploid:low.conf
CGTTGTCGGCAATTGA-1	c2:aneuploid:low.conf
CGTTGTTTCAATTCCC-1	c2:aneuploid:low.conf
CGTTTAAGCGGAGCAC-1	c2:aneuploid:low.conf
CGTTTACAAGGCAGCT-1	c2:aneuploid:low.conf
CGTTTCACTTCGGGCG-1	c2:aneuploid:low.conf
CGTTTCGCTCATTACA-1	c1:diploid:low.conf
CGTTTGTGTAGAGGGT-1	c1:diploid:low.conf
CTAAACGGGTGTAATC-1	c2:aneuploid:low.conf
CTAAAGAATGCCTACT-1	c2:aneuploid:low.conf
CTAAAGGATGAGATAC-1	c1:diploid:low.conf
CTAAAGGGAAATAGGA-1	c2:aneuploid:low.conf
CTAAATCCGGTGTACA-1	c1:diploid:low.conf
CTAAATCCTATTCCGG-1	c2:aneuploid:low.conf
CTAACCGCGCGCCCGT-1	c2:aneuploid:low.conf
CTAACGAAACTTGCTG-1	c2:aneuploid:low.conf
CTAACTGATAATCGCC-1	c2:aneuploid:low.conf
CTAACTGGTCCGGTTC-1	c1:diploid:low.conf
CTAAGGGAATGATTGG-1	c2:aneuploid:low.conf
CTAAGTACAGGGCTAC-1	c2:aneuploid:low.conf
CTAATTATGAAGCGTA-1	c2:aneuploid:low.conf
CTAATTCGCACGCGCT-1	c2:aneuploid:low.conf
CTAATTCTCAGATATT-1	c1:diploid:low.conf
CTAATTTCAACAACAC-1	c2:aneuploid:low.conf
CTACAAGAAATAACCC-1	c1:diploid:low.conf
CTACACTAGCTTGTTC-1	c2:aneuploid:low.conf
CTACACTCGCAGATGG-1	c2:aneuploid:low.conf
CTACCCTAAGGTCATA-1	c2:aneuploid:low.conf
CTACGAACTAGGTCGA-1	c2:aneuploid:low.conf
CTACGATCCTATCCTA-1	c1:diploid:low.conf
CTACGCACGGAGTACC-1	c2:aneuploid:low.conf
CTACGCCATTTCCGAT-1	c2:aneuploid:low.conf
CTACGTGTTGCCACCA-1	c2:aneuploid:low.conf
CTACTATCTTTCAGAG-1	c2:aneuploid:low.conf
CTACTCAAGGTATAGT-1	c1:diploid:low.conf
CTACTGCCACCTGACC-1	c2:aneuploid:low.conf
CTAGACATATATGTAG-1	c2:aneuploid:low.conf
CTAGACTGCATTTCGT-1	c2:aneuploid:low.conf
CTAGATAAACTCCTCG-1	c2:aneuploid:low.conf
CTAGATGTGAGTGTAA-1	c2:aneuploid:low.conf
CTAGATTTACGACGGC-1	c2:aneuploid:low.conf
CTAGCATAGTATAATG-1	c2:aneuploid:low.conf
CTAGCCCGGGAGACGA-1	c2:aneuploid:low.conf
CTAGCCGATGTTATGA-1	c1:diploid:low.conf
CTAGCTTAATGGTCCC-1	c2:aneuploid:low.conf
CTAGGCGCCCTATCAG-1	c2:aneuploid:low.conf
CTAGGGATAGGGACAA-1	c2:aneuploid:low.conf
CTAGGTCTGAAGGAAT-1	c2:aneuploid:low.conf
CTAGGTTCGGACGTGA-1	c2:aneuploid:low.conf
CTAGTAGAAAGGGATT-1	c2:aneuploid:low.conf
CTAGTATTCGGAATTA-1	c2:aneuploid:low.conf
CTAGTCACGTCTTAAG-1	c2:aneuploid:low.conf
CTAGTGAAGGACAGGA-1	c2:aneuploid:low.conf
CTAGTTACAACCCGGT-1	c2:aneuploid:low.conf
CTAGTTGGGCCCGGTA-1	c2:aneuploid:low.conf
CTATAAGAGCCAATCG-1	c2:aneuploid:low.conf
CTATAGGCGTTGATGT-1	c1:diploid:low.conf
CTATATCCAGCCTGGC-1	c2:aneuploid:low.conf
CTATCACAACGCTGGA-1	c2:aneuploid:low.conf
CTATCGACGAAATACA-1	c2:aneuploid:low.conf
CTATCGGGTCTCAACA-1	c2:aneuploid:low.conf
CTATGAACACCTTGCC-1	c2:aneuploid:low.conf
CTATGCCCGAATGCAA-1	c2:aneuploid:low.conf
CTATGGGAAGCGGAAT-1	c2:aneuploid:low.conf
CTATGTCACTAGCCCA-1	c2:aneuploid:low.conf
CTATGTCTATTGAAAC-1	c2:aneuploid:low.conf
CTATTCATGTGTCCCA-1	c2:aneuploid:low.conf
CTATTGTGTTTGGTCA-1	c2:aneuploid:low.conf
CTATTTGCTTGGAGGA-1	c2:aneuploid:low.conf
CTATTTGGTTACGGAT-1	c2:aneuploid:low.conf
CTCAAACCACTGCCCG-1	c2:aneuploid:low.conf
CTCAACTAACCCGGAT-1	c2:aneuploid:low.conf
CTCAAGACATTAGCGC-1	c2:aneuploid:low.conf
CTCACACGCAAGCCTA-1	c2:aneuploid:low.conf
CTCACATTTACTAAAT-1	c2:aneuploid:low.conf
CTCACCGATCCAAACT-1	c2:aneuploid:low.conf
CTCACTGTGATACTTA-1	c2:aneuploid:low.conf
CTCAGAGCTAATGTCG-1	c2:aneuploid:low.conf
CTCAGGACTCACCTGT-1	c2:aneuploid:low.conf
CTCAGTCACGACAAAT-1	c2:aneuploid:low.conf
CTCATCACTTAGTGAT-1	c2:aneuploid:low.conf
CTCATGGCTCACAATC-1	c2:aneuploid:low.conf
CTCATTAACGTTGCCC-1	c2:aneuploid:low.conf
CTCATTGCTCTAACAA-1	c2:aneuploid:low.conf
CTCATTTGATGGGCGG-1	c2:aneuploid:low.conf
CTCCCAATGAGTCGCG-1	c2:aneuploid:low.conf
CTCCGCCCACATGAGG-1	c2:aneuploid:low.conf
CTCCGGCCTAATATGC-1	c2:aneuploid:low.conf
CTCCGGCTTGTAGACA-1	c2:aneuploid:low.conf
CTCCTAAGTTATGTCT-1	c2:aneuploid:low.conf
CTCCTAGTAATCGTGA-1	c1:diploid:low.conf
CTCCTCCAGCTCACAC-1	c2:aneuploid:low.conf
CTCCTGTTCAAGGCAG-1	c2:aneuploid:low.conf
CTCCTTTACGCAAGTC-1	c2:aneuploid:low.conf
CTCGAATGGAACGTAT-1	c2:aneuploid:low.conf
CTCGAGATCCAAAGCA-1	c1:diploid:low.conf
CTCGAGGCAAGTTTCA-1	c2:aneuploid:low.conf
CTCGAGGTCGAACAGT-1	c2:aneuploid:low.conf
CTCGATATTTGCGAGC-1	c1:diploid:low.conf
CTCGCACCTATATAGT-1	c2:aneuploid:low.conf
CTCGCCGAATGTAGGG-1	c2:aneuploid:low.conf
CTCGGGATAACACCTA-1	c2:aneuploid:low.conf
CTCGGGCATCGTCGGG-1	c2:aneuploid:low.conf
CTCGGTACCACTGCTC-1	c2:aneuploid:low.conf
CTCGGTCCGTAGCCTG-1	c2:aneuploid:low.conf
CTCGGTTGTCGGCCCT-1	c2:aneuploid:low.conf
CTCGTCTGTGCCTTCG-1	c2:aneuploid:low.conf
CTCGTGGCACTGAAAG-1	c1:diploid:low.conf
CTCGTTACGGCTACCA-1	c2:aneuploid:low.conf
CTCGTTTCTAATGTTT-1	c1:diploid:low.conf
CTCTAATGCATTGATC-1	c2:aneuploid:low.conf
CTCTACATCCTGCGTG-1	c2:aneuploid:low.conf
CTCTAGCCCTCGGAAA-1	c2:aneuploid:low.conf
CTCTATTTGGCTGCAG-1	c2:aneuploid:low.conf
CTCTCACAATCGATGA-1	c2:aneuploid:low.conf
CTCTCGATGTGCGCCT-1	c2:aneuploid:low.conf
CTCTGCAGGCATTCTT-1	c2:aneuploid:low.conf
CTCTGCGAAGCAAGCA-1	c2:aneuploid:low.conf
CTCTGGACGCCTGGTG-1	c2:aneuploid:low.conf
CTCTGTGCCTGCTATG-1	c2:aneuploid:low.conf
CTCTGTTTGAGGATTC-1	c2:aneuploid:low.conf
CTCTTCTATTGACTGG-1	c2:aneuploid:low.conf
CTCTTCTGGAAGTTAG-1	c1:diploid:low.conf
CTCTTGTCCCGCTTGG-1	c2:aneuploid:low.conf
CTGAAACGGCCCTCAG-1	c2:aneuploid:low.conf
CTGAAAGAGATCCGAC-1	c2:aneuploid:low.conf
CTGAATCCGAGACCTC-1	c2:aneuploid:low.conf
CTGAATTTATTGCCAG-1	c2:aneuploid:low.conf
CTGACATAGAAATAGA-1	c2:aneuploid:low.conf
CTGACTGCGCAGCTCG-1	c2:aneuploid:low.conf
CTGAGAAAGTTCGGCG-1	c2:aneuploid:low.conf
CTGAGCAAGTAACAAG-1	c2:aneuploid:low.conf
CTGAGCGAGACTTATT-1	c2:aneuploid:low.conf
CTGATCCCTTTATGCA-1	c2:aneuploid:low.conf
CTGCAAATGGGCTCCA-1	c2:aneuploid:low.conf
CTGCACAACTACATAT-1	c2:aneuploid:low.conf
CTGCACCTAGTCCACA-1	c2:aneuploid:low.conf
CTGCACCTGGAACCGC-1	c2:aneuploid:low.conf
CTGCACTCCAGTACAG-1	c2:aneuploid:low.conf
CTGCAGAGAATCAGAG-1	c2:aneuploid:low.conf
CTGCCAAGGTTGGAAG-1	c2:aneuploid:low.conf
CTGCCATGCATCACAT-1	c2:aneuploid:low.conf
CTGCCTAGCCACCAAG-1	c2:aneuploid:low.conf
CTGCCTCATATGCAAC-1	c2:aneuploid:low.conf
CTGCCTTTAATACCTT-1	c2:aneuploid:low.conf
CTGCCTTTCTAGTAAA-1	c1:diploid:low.conf
CTGCGACCTCGCCGAA-1	c2:aneuploid:low.conf
CTGCGATTTCGAGATT-1	c2:aneuploid:low.conf
CTGCGGTAGTCACGTG-1	c2:aneuploid:low.conf
CTGCGTTACGATATAA-1	c2:aneuploid:low.conf
CTGCTCTGACGGCAAA-1	c2:aneuploid:low.conf
CTGCTGAGGCCACGAA-1	c2:aneuploid:low.conf
CTGCTGTCTAACGAGC-1	c2:aneuploid:low.conf
CTGCTTGGCGATAGCT-1	c2:aneuploid:low.conf
CTGCTTTATGTCCGCG-1	c2:aneuploid:low.conf
CTGGAAATGGATGCTT-1	c1:diploid:low.conf
CTGGAAGACACGGTGG-1	c2:aneuploid:low.conf
CTGGATTTACACTTGA-1	c2:aneuploid:low.conf
CTGGCGACATAAGTCC-1	c2:aneuploid:low.conf
CTGGCGCACAGGTCTG-1	c2:aneuploid:low.conf
CTGGCGGGAATAAGTA-1	c2:aneuploid:low.conf
CTGGCTCCTGCGGGAT-1	c1:diploid:low.conf
CTGGCTGATTCATCCT-1	c2:aneuploid:low.conf
CTGGCTGCTAACGTAA-1	c1:diploid:low.conf
CTGGCTGGTTGTCAGT-1	c2:aneuploid:low.conf
CTGGGATAAATAATGG-1	c2:aneuploid:low.conf
CTGGGATACGCTACCC-1	c2:aneuploid:low.conf
CTGGGATCGCCCAGAT-1	c2:aneuploid:low.conf
CTGGGCGGCCAAATGT-1	c2:aneuploid:low.conf
CTGGGCTATCCTTTGG-1	c2:aneuploid:low.conf
CTGGGTAGGCAGTTAA-1	c2:aneuploid:low.conf
CTGGTAAAGACTTACA-1	c1:diploid:low.conf
CTGGTAACACATAGAA-1	c2:aneuploid:low.conf
CTGGTAACGAGCTCTT-1	c2:aneuploid:low.conf
CTGGTCATTCCAATCC-1	c2:aneuploid:low.conf
CTGGTCCTAACTTGGC-1	c2:aneuploid:low.conf
CTGGTTCAACGCATCA-1	c2:aneuploid:low.conf
CTGGTTCGCGAGCTAC-1	c2:aneuploid:low.conf
CTGGTTTCGAGCAAGA-1	c2:aneuploid:low.conf
CTGTACTTCTTAGCAT-1	c2:aneuploid:low.conf
CTGTAGCCATCTCACT-1	c2:aneuploid:low.conf
CTGTAGTGAGGATCGA-1	c2:aneuploid:low.conf
CTGTATGGTGTAGAAA-1	c2:aneuploid:low.conf
CTGTCAAATGGCTCGG-1	c2:aneuploid:low.conf
CTGTCACGCCAGGCGC-1	c2:aneuploid:low.conf
CTGTGCAGGGTAGGTC-1	c2:aneuploid:low.conf
CTGTGGTCGGGAGATA-1	c2:aneuploid:low.conf
CTGTTACCCAATCTAG-1	c2:aneuploid:low.conf
CTGTTCACTGCCTGTG-1	c2:aneuploid:low.conf
CTGTTCATCTCACGGG-1	c2:aneuploid:low.conf
CTGTTGTTCAGTCGTA-1	c1:diploid:low.conf
CTTAACTTACAGTATA-1	c2:aneuploid:low.conf
CTTAACTTCGAAGTAC-1	c2:aneuploid:low.conf
CTTAATCGACTTAGTA-1	c2:aneuploid:low.conf
CTTACACGGTATTCCA-1	c2:aneuploid:low.conf
CTTACACTGGGAAATA-1	c2:aneuploid:low.conf
CTTACATAGATTTCTT-1	c2:aneuploid:low.conf
CTTAGATGTTTCATCC-1	c2:aneuploid:low.conf
CTTAGCCTTCCACATG-1	c2:aneuploid:low.conf
CTTAGGTCCCAATCGT-1	c2:aneuploid:low.conf
CTTAGTAGGCCTACAG-1	c2:aneuploid:low.conf
CTTAGTGTAGTAGCAT-1	c2:aneuploid:low.conf
CTTAGTTGAGGAATCG-1	c2:aneuploid:low.conf
CTTATGTTGACTACCA-1	c2:aneuploid:low.conf
CTTCAACTCCACTTGG-1	c2:aneuploid:low.conf
CTTCACGCCCTGGTAC-1	c2:aneuploid:low.conf
CTTCATAGCTCAAGAA-1	c2:aneuploid:low.conf
CTTCATTGTCAGTGGA-1	c2:aneuploid:low.conf
CTTCCGCTCCGTGAAG-1	c2:aneuploid:low.conf
CTTCCTGCATATTTAC-1	c2:aneuploid:low.conf
CTTCGATTGCGCAAGC-1	c2:aneuploid:low.conf
CTTCGGCCAATTGTTT-1	c2:aneuploid:low.conf
CTTCGTAGATAGGTGA-1	c1:diploid:low.conf
CTTCTATTAATGCTAG-1	c2:aneuploid:low.conf
CTTCTGGGCGTACCTA-1	c1:diploid:low.conf
CTTCTTACGTCGTATA-1	c2:aneuploid:low.conf
CTTGACCCGAAAGATA-1	c2:aneuploid:low.conf
CTTGAGGTTATCCCGA-1	c2:aneuploid:low.conf
CTTGAGTTAGGGTAAT-1	c2:aneuploid:low.conf
CTTGATGACCATCCAG-1	c2:aneuploid:low.conf
CTTGCCCACCCACGCA-1	c1:diploid:low.conf
CTTGCCCAGGCTCTAC-1	c2:aneuploid:low.conf
CTTGGCCAAGCTGGGA-1	c2:aneuploid:low.conf
CTTGTACTTGTTGACT-1	c2:aneuploid:low.conf
CTTGTCAACATTCGAG-1	c2:aneuploid:low.conf
CTTGTCGTACGTGTCA-1	c2:aneuploid:low.conf
CTTGTGAGTCTTTGAC-1	c2:aneuploid:low.conf
CTTGTGCTCACCGATT-1	c2:aneuploid:low.conf
CTTGTTGCTGAGTCAA-1	c2:aneuploid:low.conf
CTTGTTTATGTAGCCA-1	c2:aneuploid:low.conf
CTTTAACTTTCAAAGG-1	c2:aneuploid:low.conf
CTTTAATATTGGTCGA-1	c2:aneuploid:low.conf
CTTTACCGAATAGTAG-1	c2:aneuploid:low.conf
CTTTAGGAACACTGTT-1	c2:aneuploid:low.conf
CTTTAGTGCTATTATT-1	c1:diploid:low.conf
CTTTATCCGACGCATG-1	c1:diploid:low.conf
CTTTCTGTGCGGGCTT-1	c2:aneuploid:low.conf
CTTTGCATCGCTCTTG-1	c2:aneuploid:low.conf
CTTTGCTGTCATGGAT-1	c2:aneuploid:low.conf
CTTTGGCAGACAGAGT-1	c2:aneuploid:low.conf
CTTTGGCTTTAGTAAA-1	c2:aneuploid:low.conf
CTTTGGGATTGTTGCA-1	c2:aneuploid:low.conf
GAAACAGATGACCACC-1	c2:aneuploid:low.conf
GAAACAGCCATGCAGT-1	c2:aneuploid:low.conf
GAAACCATGGTGCGCT-1	c2:aneuploid:low.conf
GAAACCGAATTACCTT-1	c2:aneuploid:low.conf
GAAACCTATACAAATG-1	c2:aneuploid:low.conf
GAAACTCGTGCGATGC-1	c2:aneuploid:low.conf
GAAACTCTAATGAAGG-1	c2:aneuploid:low.conf
GAAAGAACAGCGTTAT-1	c2:aneuploid:low.conf
GAAAGCAGTGCACTTT-1	c2:aneuploid:low.conf
GAAAGTGACTAACTGC-1	c2:aneuploid:low.conf
GAAATACCTGCTGGCT-1	c2:aneuploid:low.conf
GAAATACTAAACGTTT-1	c2:aneuploid:low.conf
GAAATATGCTTGAATG-1	c2:aneuploid:low.conf
GAAATCGCGCGCAACT-1	c2:aneuploid:low.conf
GAAATGGCGGTGTTAG-1	c1:diploid:low.conf
GAAATGGGATGTAAAC-1	c2:aneuploid:low.conf
GAAATTAGCACGGATA-1	c1:diploid:low.conf
GAAATTCACATCGCTG-1	c2:aneuploid:low.conf
GAAATTGTCTCTATAA-1	c2:aneuploid:low.conf
GAACAACTGGGATGAA-1	c2:aneuploid:low.conf
GAACACACATCAACCA-1	c2:aneuploid:low.conf
GAACAGATTACTAAAT-1	c2:aneuploid:low.conf
GAACATTAGTATGTTA-1	c2:aneuploid:low.conf
GAACCATCTGGGAGAC-1	c2:aneuploid:low.conf
GAACCCTCTGTGTTCT-1	c2:aneuploid:low.conf
GAACCTTTAACGATCC-1	c2:aneuploid:low.conf
GAACGACCGAATGATA-1	c2:aneuploid:low.conf
GAACGATAAGTTAAAG-1	c2:aneuploid:low.conf
GAACGCGGGTCACACG-1	c2:aneuploid:low.conf
GAACGTCTCATGGTCG-1	c2:aneuploid:low.conf
GAACTGTGGAGAGACA-1	c2:aneuploid:low.conf
GAACTTAGCGCCCGGT-1	c2:aneuploid:low.conf
GAACTTGTGCACGGGA-1	c2:aneuploid:low.conf
GAAGAAACGATATTGT-1	c2:aneuploid:low.conf
GAAGAACGGTGCAGGT-1	c2:aneuploid:low.conf
GAAGACTTCAATGCCG-1	c2:aneuploid:low.conf
GAAGCAAGGCAATGTT-1	c2:aneuploid:low.conf
GAAGCCACTGATTATG-1	c2:aneuploid:low.conf
GAAGCCTGCACATTCC-1	c2:aneuploid:low.conf
GAAGCGTGAGGAATTT-1	c2:aneuploid:low.conf
GAAGCTTGCTGACCGC-1	c2:aneuploid:low.conf
GAAGGACTAAATTGAA-1	c2:aneuploid:low.conf
GAAGGAGTCGAGTGCG-1	c2:aneuploid:low.conf
GAAGGCTACCATTGTT-1	c2:aneuploid:low.conf
GAAGGGTCATTAAGAC-1	c2:aneuploid:low.conf
GAAGTCAGTTGCACTA-1	c2:aneuploid:low.conf
GAAGTCTCCCTAGCGA-1	c2:aneuploid:low.conf
GAAGTGATTTATCGTG-1	c1:diploid:low.conf
GAAGTGCTGGATAGCT-1	c2:aneuploid:low.conf
GAAGTTTCCACTCAAT-1	c2:aneuploid:low.conf
GAATAGACGCGACCCA-1	c2:aneuploid:low.conf
GAATAGCATTTAGGGT-1	c2:aneuploid:low.conf
GAATAGCCCTGCGGTC-1	c2:aneuploid:low.conf
GAATAGTGCTCGATTA-1	c1:diploid:low.conf
GAATATTCGGAGTCCC-1	c2:aneuploid:low.conf
GAATCGCCGGACACGG-1	c2:aneuploid:low.conf
GAATCTATACTCGGAC-1	c2:aneuploid:low.conf
GAATCTGAACATTCTC-1	c2:aneuploid:low.conf
GAATGAAGGTCTTCAG-1	c2:aneuploid:low.conf
GAATGCCGAAATGACC-1	c2:aneuploid:low.conf
GAATGCGAATCGGTTC-1	c2:aneuploid:low.conf
GAATGTATGGCAGGTC-1	c2:aneuploid:low.conf
GAATGTGGTCCGGATT-1	c2:aneuploid:low.conf
GAATGTTGGGTAATCT-1	c2:aneuploid:low.conf
GAATTATAGTGAAAGG-1	c2:aneuploid:low.conf
GAATTCACCCGGGTGT-1	c2:aneuploid:low.conf
GAATTTCTCGCTGCAG-1	c2:aneuploid:low.conf
GACAAACATATGCAGG-1	c2:aneuploid:low.conf
GACAACGACCATTGAA-1	c2:aneuploid:low.conf
GACAACGCAGCTTACG-1	c2:aneuploid:low.conf
GACAAGAGATGAGATT-1	c2:aneuploid:low.conf
GACACAAGGGAAGAAA-1	c2:aneuploid:low.conf
GACACCCAAAGACGCG-1	c2:aneuploid:low.conf
GACACGAGTTAGAGGA-1	c2:aneuploid:low.conf
GACACTGAGTTCAGTG-1	c2:aneuploid:low.conf
GACACTGGAACCCGAT-1	c2:aneuploid:low.conf
GACACTTCCAATTACC-1	c2:aneuploid:low.conf
GACAGAGGTCTTCAGT-1	c2:aneuploid:low.conf
GACAGCCAGACCTGAC-1	c2:aneuploid:low.conf
GACATCCGTCGAACTG-1	c2:aneuploid:low.conf
GACATCGATTTATAAC-1	c2:aneuploid:low.conf
GACCAAACGTTGACTG-1	c2:aneuploid:low.conf
GACCACACTTCCCTTT-1	c2:aneuploid:low.conf
GACCAGAGCCCTGTAG-1	c2:aneuploid:low.conf
GACCAGGTCATTCATA-1	c2:aneuploid:low.conf
GACCCGTCGCCGGCTA-1	c2:aneuploid:low.conf
GACCGACGTGAAAGCA-1	c2:aneuploid:low.conf
GACCGCGTCTGACGTG-1	c2:aneuploid:low.conf
GACCGTCAGGTCGTGA-1	c2:aneuploid:low.conf
GACCGTGCTGACGGTG-1	c2:aneuploid:low.conf
GACCTTCCACGTCTAC-1	c2:aneuploid:low.conf
GACGACGATCCGCGTT-1	c2:aneuploid:low.conf
GACGAGGCTAATAAAC-1	c2:aneuploid:low.conf
GACGATATCACTGGGT-1	c2:aneuploid:low.conf
GACGCCGTAAAGGCTA-1	c2:aneuploid:low.conf
GACGCCTGTTGCAGGG-1	c2:aneuploid:low.conf
GACGCTTGCTTCTAAA-1	c2:aneuploid:low.conf
GACGGACCGCGTTCCT-1	c2:aneuploid:low.conf
GACGGGATGTCTTATG-1	c2:aneuploid:low.conf
GACGGGTTGGCCCGTA-1	c2:aneuploid:low.conf
GACGGTCAATAGAAGC-1	c2:aneuploid:low.conf
GACGGTCCTAGGGTGT-1	c2:aneuploid:low.conf
GACGTGAGACTCCATG-1	c2:aneuploid:low.conf
GACGTGTAGGGATTAT-1	c1:diploid:low.conf
GACGTTCGTAAATACA-1	c2:aneuploid:low.conf
GACGTTGCTCGGCGGC-1	c2:aneuploid:low.conf
GACTAACACAGCACCT-1	c2:aneuploid:low.conf
GACTAAGATCATGCAC-1	c2:aneuploid:low.conf
GACTAAGTAGGCTCAC-1	c2:aneuploid:low.conf
GACTACAATTGCTCGT-1	c2:aneuploid:low.conf
GACTAGGCCGTTAGGT-1	c2:aneuploid:low.conf
GACTCACCCACGTGAG-1	c2:aneuploid:low.conf
GACTCCCAGAATAAGG-1	c2:aneuploid:low.conf
GACTCGCGGGAATGAC-1	c2:aneuploid:low.conf
GACTCGGTCGGCGGAT-1	c2:aneuploid:low.conf
GACTCTAGAGTTCCAA-1	c1:diploid:low.conf
GACTGATTGGTCACAA-1	c2:aneuploid:low.conf
GACTGCAAATCGAGCT-1	c2:aneuploid:low.conf
GACTGCACCAGCCCAG-1	c2:aneuploid:low.conf
GACTGCGGCACGTGTA-1	c2:aneuploid:low.conf
GACTGCTGGTGAGAAA-1	c2:aneuploid:low.conf
GACTGGGCGCCGCAAC-1	c2:aneuploid:low.conf
GACTTTCGAGCGGTTC-1	c2:aneuploid:low.conf
GAGAACGGTTCTGACT-1	c1:diploid:low.conf
GAGACCCTGCAACGCC-1	c2:aneuploid:low.conf
GAGACTGATGGGTAGA-1	c2:aneuploid:low.conf
GAGACTTCGCGACCGA-1	c2:aneuploid:low.conf
GAGAGGGCGCGAGGTT-1	c2:aneuploid:low.conf
GAGAGTCTCGGGAGAG-1	c2:aneuploid:low.conf
GAGATCTGCTTGGCAT-1	c2:aneuploid:low.conf
GAGATCTGTCACTCCG-1	c2:aneuploid:low.conf
GAGATCTTCCATGACA-1	c2:aneuploid:low.conf
GAGATGACAATCCTTA-1	c2:aneuploid:low.conf
GAGATGGCTTTAATCA-1	c2:aneuploid:low.conf
GAGATGGGAGTCGACA-1	c2:aneuploid:low.conf
GAGCACCTGTGTCCAG-1	c2:aneuploid:low.conf
GAGCACGGCGCCTCTT-1	c1:diploid:low.conf
GAGCATCAACAACTTG-1	c1:diploid:low.conf
GAGCATCATCCCTGGG-1	c2:aneuploid:low.conf
GAGCCACGGTAGTAGG-1	c2:aneuploid:low.conf
GAGCCAGCTACCTGTG-1	c2:aneuploid:low.conf
GAGCCGAGCGTTTATT-1	c2:aneuploid:low.conf
GAGCGAGGGAGTACCG-1	c2:aneuploid:low.conf
GAGCGCAAATACTCCG-1	c2:aneuploid:low.conf
GAGCGCGCACGAGTAG-1	c2:aneuploid:low.conf
GAGCGGAATGCGGTGT-1	c2:aneuploid:low.conf
GAGCTAAGGGCATATC-1	c2:aneuploid:low.conf
GAGCTCAACATGAGCG-1	c2:aneuploid:low.conf
GAGCTCTCGGACCTAA-1	c2:aneuploid:low.conf
GAGCTGTCGTCTCGGA-1	c2:aneuploid:low.conf
GAGGAATATCTCTTTG-1	c2:aneuploid:low.conf
GAGGAATGGAGAGGTT-1	c2:aneuploid:low.conf
GAGGAGTAATTCCTAC-1	c2:aneuploid:low.conf
GAGGATAAACAGTGCT-1	c2:aneuploid:low.conf
GAGGCATTTGCAGCAG-1	c2:aneuploid:low.conf
GAGGGAGTCAGATCGC-1	c2:aneuploid:low.conf
GAGGGCATCGCGTATC-1	c2:aneuploid:low.conf
GAGGGCCATAATATTA-1	c2:aneuploid:low.conf
GAGGGCCGGCAGAGTC-1	c2:aneuploid:low.conf
GAGGGCGCAGCTCTGC-1	c2:aneuploid:low.conf
GAGGGTAGTAACAAAG-1	c1:diploid:low.conf
GAGGTACATCCATCTT-1	c2:aneuploid:low.conf
GAGGTACGCGTGTCCC-1	c2:aneuploid:low.conf
GAGGTCCCAAAGATCT-1	c2:aneuploid:low.conf
GAGGTCCGTTCGCTGT-1	c2:aneuploid:low.conf
GAGTAAACCGGAAAGT-1	c2:aneuploid:low.conf
GAGTAGATACTAGTTG-1	c2:aneuploid:low.conf
GAGTATACCCTAATCA-1	c2:aneuploid:low.conf
GAGTATGCCCGCCTTG-1	c2:aneuploid:low.conf
GAGTATGCGCGTGCAT-1	c2:aneuploid:low.conf
GAGTCAGACCAGAATC-1	c2:aneuploid:low.conf
GAGTCCGCTTACCGGA-1	c2:aneuploid:low.conf
GAGTGCACGGACAACA-1	c2:aneuploid:low.conf
GAGTGTCAACCAGAAA-1	c2:aneuploid:low.conf
GAGTGTGCGGTACCCA-1	c2:aneuploid:low.conf
GATAAATCGGTGGATG-1	c2:aneuploid:low.conf
GATAACTCGCACTGTG-1	c2:aneuploid:low.conf
GATAAGGCAGATGCAA-1	c2:aneuploid:low.conf
GATACCGTGTCGGAGT-1	c2:aneuploid:low.conf
GATACGATGGGAGTCA-1	c2:aneuploid:low.conf
GATAGAACCCGCTAGG-1	c2:aneuploid:low.conf
GATAGGATTAATTACA-1	c2:aneuploid:low.conf
GATAGGTAACGTTGAC-1	c2:aneuploid:low.conf
GATAGGTGTCCCGGGC-1	c2:aneuploid:low.conf
GATAGTGCGAGTAAGT-1	c2:aneuploid:low.conf
GATATCTCATGCAATA-1	c2:aneuploid:low.conf
GATATGAGACACTAAC-1	c2:aneuploid:low.conf
GATATGCGGTAGCCAA-1	c2:aneuploid:low.conf
GATATGGATTACGCGG-1	c2:aneuploid:low.conf
GATATTGAGATTGGCG-1	c2:aneuploid:low.conf
GATATTTCCTACATGG-1	c2:aneuploid:low.conf
GATCAACATAAAGGGA-1	c1:diploid:low.conf
GATCATTCCAAACATT-1	c2:aneuploid:low.conf
GATCCCTTTATACTGC-1	c2:aneuploid:low.conf
GATCCGAATATAAGTG-1	c2:aneuploid:low.conf
GATCCGGGAATTAACA-1	c2:aneuploid:low.conf
GATCCTAAATCGGGAC-1	c2:aneuploid:low.conf
GATCCTCGACACTGGC-1	c2:aneuploid:low.conf
GATCCTCTTGCGCTTA-1	c2:aneuploid:low.conf
GATCGCGGGCTCTCCA-1	c2:aneuploid:low.conf
GATCGCTACCCGATTT-1	c2:aneuploid:low.conf
GATCGCTGTGGTGCGT-1	c1:diploid:low.conf
GATCGGCGATAAGTCG-1	c2:aneuploid:low.conf
GATCGGTGGCCATAAC-1	c2:aneuploid:low.conf
GATCGTGACTGATATC-1	c2:aneuploid:low.conf
GATCTCGACGCTGTGG-1	c2:aneuploid:low.conf
GATCTGCTATCTAAGG-1	c2:aneuploid:low.conf
GATCTTGGAGGGCATA-1	c2:aneuploid:low.conf
GATCTTTGCAGGGTAT-1	c2:aneuploid:low.conf
GATCTTTGCTCAAAGA-1	c2:aneuploid:low.conf
GATGACAAGTAGGGCA-1	c2:aneuploid:low.conf
GATGACGATGATCGCG-1	c2:aneuploid:low.conf
GATGAGGAACCTTCGG-1	c2:aneuploid:low.conf
GATGATTTGAAACTGG-1	c1:diploid:low.conf
GATGCCACACTACAGC-1	c2:aneuploid:low.conf
GATGCCAGCAGAAGGC-1	c2:aneuploid:low.conf
GATGCGTCCTGCATTC-1	c2:aneuploid:low.conf
GATGCTACAAGCGCCT-1	c2:aneuploid:low.conf
GATGCTACCTTCGATG-1	c2:aneuploid:low.conf
GATGCTGTATTTCATC-1	c2:aneuploid:low.conf
GATGGCGCACACATTA-1	c2:aneuploid:low.conf
GATGGTGAAATAACCC-1	c2:aneuploid:low.conf
GATGGTGCCCTAGGCA-1	c2:aneuploid:low.conf
GATGTCCGGATCACAT-1	c2:aneuploid:low.conf
GATGTCGGTCAACTGC-1	c2:aneuploid:low.conf
GATGTGTTGTCACAAG-1	c2:aneuploid:low.conf
GATGTTCAATCCACGA-1	c1:diploid:low.conf
GATGTTTGTGCGAGAT-1	c2:aneuploid:low.conf
GATTAACCGAAAGCCC-1	c2:aneuploid:low.conf
GATTACTGAATTTGGG-1	c2:aneuploid:low.conf
GATTAGAAACAAGCGT-1	c2:aneuploid:low.conf
GATTCCCTTGTCGCAG-1	c2:aneuploid:low.conf
GATTCCGCGTTTCCGT-1	c2:aneuploid:low.conf
GATTCCTATACGGCGC-1	c2:aneuploid:low.conf
GATTCGACGGTTCACG-1	c2:aneuploid:low.conf
GATTCTGTTAATGAGT-1	c2:aneuploid:low.conf
GATTGACACTCTGCTC-1	c2:aneuploid:low.conf
GATTGCTCCAGTTGCA-1	c2:aneuploid:low.conf
GATTGGGAAAGGTTGT-1	c2:aneuploid:low.conf
GATTTAGTGCGTACTG-1	c2:aneuploid:low.conf
GATTTGCGCTAACACC-1	c2:aneuploid:low.conf
GCAAACCCTACATTAT-1	c2:aneuploid:low.conf
GCAAACCTTGGCCATA-1	c2:aneuploid:low.conf
GCAAACGTCGCCAGGT-1	c2:aneuploid:low.conf
GCAAAGGGCGTTAGCC-1	c1:diploid:low.conf
GCAAATATTACGCTTT-1	c2:aneuploid:low.conf
GCAACAGCAGTATGCG-1	c2:aneuploid:low.conf
GCAACCACCAGACCGG-1	c2:aneuploid:low.conf
GCAACGGCTAGTTATG-1	c2:aneuploid:low.conf
GCAAGAATTCCTTGGC-1	c2:aneuploid:low.conf
GCAAGATGTGTTCGCG-1	c2:aneuploid:low.conf
GCAAGTGTAAAGCATG-1	c2:aneuploid:low.conf
GCAATTAGTCGCACCG-1	c2:aneuploid:low.conf
GCACAAACCCTAGATG-1	c2:aneuploid:low.conf
GCACAAACGAGGCGTG-1	c2:aneuploid:low.conf
GCACAAGTGTCGGAAG-1	c2:aneuploid:low.conf
GCACACACTGGTAGCC-1	c2:aneuploid:low.conf
GCACACAGCTATTACC-1	c2:aneuploid:low.conf
GCACAGCACGGGCCGA-1	c2:aneuploid:low.conf
GCACGCCGATTCCCGC-1	c2:aneuploid:low.conf
GCACGCCTACTTAGAT-1	c1:diploid:low.conf
GCACGTGGTTTACTTA-1	c1:diploid:low.conf
GCACTAGTCGCGCTAT-1	c2:aneuploid:low.conf
GCACTCCCACAGTCCC-1	c2:aneuploid:low.conf
GCACTGCCTACCTTTA-1	c2:aneuploid:low.conf
GCACTGTGCAAATGTA-1	c2:aneuploid:low.conf
GCAGAAACGTAATCCA-1	c2:aneuploid:low.conf
GCAGAAGGTAATCTCC-1	c2:aneuploid:low.conf
GCAGACCCAGCACGTA-1	c2:aneuploid:low.conf
GCAGATCCATAAGACT-1	c2:aneuploid:low.conf
GCAGATTAGGGATATC-1	c2:aneuploid:low.conf
GCAGCACACAGCCCAG-1	c2:aneuploid:low.conf
GCAGCCTATATCACAT-1	c2:aneuploid:low.conf
GCAGCGGTGGGCATTA-1	c2:aneuploid:low.conf
GCAGCTATGGACAGGT-1	c2:aneuploid:low.conf
GCAGGACTATAGAATA-1	c2:aneuploid:low.conf
GCAGGTAGAGTATGGT-1	c2:aneuploid:low.conf
GCAGTGTGGCTATAGG-1	c2:aneuploid:low.conf
GCATAAATTGAACGCC-1	c2:aneuploid:low.conf
GCATAGAGCACTCAGG-1	c2:aneuploid:low.conf
GCATGAGGGACGCGGC-1	c2:aneuploid:low.conf
GCATGCTAATAACGAT-1	c1:diploid:low.conf
GCATTCAAGGCAACGC-1	c1:diploid:low.conf
GCATTCGAAATGAACA-1	c2:aneuploid:low.conf
GCATTTCCAAGGCTCC-1	c2:aneuploid:low.conf
GCCAACCATTTCCGGA-1	c1:diploid:low.conf
GCCAATAGGGCATCTC-1	c2:aneuploid:low.conf
GCCACAATTTAAGGAC-1	c2:aneuploid:low.conf
GCCACTCAGAGCGCGA-1	c2:aneuploid:low.conf
GCCACTCCTTACGGTA-1	c2:aneuploid:low.conf
GCCAGGAAAGAACACT-1	c2:aneuploid:low.conf
GCCAGGAGTAACCGAT-1	c2:aneuploid:low.conf
GCCAGGCGTTCGCATG-1	c2:aneuploid:low.conf
GCCATATTGCACACAG-1	c2:aneuploid:low.conf
GCCATCGAGCTGCGTG-1	c2:aneuploid:low.conf
GCCATCGATGCTGCAT-1	c2:aneuploid:low.conf
GCCCACCAAGGCTGTC-1	c2:aneuploid:low.conf
GCCCACTGGTCCACAA-1	c2:aneuploid:low.conf
GCCCAGATGCTGGAGA-1	c1:diploid:low.conf
GCCCAGTTGGTATGCC-1	c2:aneuploid:low.conf
GCCCGATCTGTGGTCG-1	c2:aneuploid:low.conf
GCCCGATGCCCAGTTC-1	c2:aneuploid:low.conf
GCCCGCGCGTAAACGG-1	c1:diploid:low.conf
GCCCGCGCGTTTGACA-1	c2:aneuploid:low.conf
GCCCGTAATACCTTCT-1	c2:aneuploid:low.conf
GCCCGTTCACACAATT-1	c1:diploid:low.conf
GCCCTAAGTGCAGGAT-1	c2:aneuploid:low.conf
GCCCTGAGGATGGGCT-1	c2:aneuploid:low.conf
GCCGAAATTCCTACGT-1	c2:aneuploid:low.conf
GCCGACCCACGACTGC-1	c2:aneuploid:low.conf
GCCGATTGGCCAAGCT-1	c2:aneuploid:low.conf
GCCGCACTCCGTTTCA-1	c1:diploid:low.conf
GCCGCTTGTGAGAAAC-1	c2:aneuploid:low.conf
GCCGGAAACACATCTT-1	c2:aneuploid:low.conf
GCCGGGTTAGGGTCGC-1	c2:aneuploid:low.conf
GCCGGTCGTATCTCTC-1	c2:aneuploid:low.conf
GCCGTCGGTTTCGGGC-1	c2:aneuploid:low.conf
GCCGTGGAAGAAATGT-1	c2:aneuploid:low.conf
GCCTACGTTCTGTGCA-1	c2:aneuploid:low.conf
GCCTATAGTGTCAGGG-1	c2:aneuploid:low.conf
GCCTATGCTGGGCCTT-1	c2:aneuploid:low.conf
GCCTATTCCGATATAG-1	c2:aneuploid:low.conf
GCCTATTTGCTACACA-1	c2:aneuploid:low.conf
GCCTCAGGTACCGGTC-1	c2:aneuploid:low.conf
GCCTCATCTGGAAATA-1	c2:aneuploid:low.conf
GCCTCCGACAATTCAC-1	c2:aneuploid:low.conf
GCCTCTATACATAGCA-1	c2:aneuploid:low.conf
GCCTGCTACACTGAGA-1	c2:aneuploid:low.conf
GCCTGTCCCGGTGCAT-1	c2:aneuploid:low.conf
GCCTTCAGCCCTACCG-1	c2:aneuploid:low.conf
GCCTTGTATATGCAGT-1	c2:aneuploid:low.conf
GCGAAACGATCGGGAG-1	c2:aneuploid:low.conf
GCGAAACTTAACTGGA-1	c2:aneuploid:low.conf
GCGAAGAATCTGACGG-1	c2:aneuploid:low.conf
GCGAAGCCATACCCGT-1	c2:aneuploid:low.conf
GCGAATGGACTAGCGA-1	c1:diploid:low.conf
GCGACATGTAAACATC-1	c2:aneuploid:low.conf
GCGACCCAACCATCTG-1	c2:aneuploid:low.conf
GCGACGATAGTTGTAC-1	c2:aneuploid:low.conf
GCGACGGTAGTCTCCT-1	c2:aneuploid:low.conf
GCGAGAGGCCATGTAA-1	c2:aneuploid:low.conf
GCGAGAGTTGCGTCCA-1	c1:diploid:low.conf
GCGAGCGCATGCTCCC-1	c2:aneuploid:low.conf
GCGAGGCCCGAGCAGA-1	c1:diploid:low.conf
GCGAGTTCTGCAAAGA-1	c2:aneuploid:low.conf
GCGATTCTGGAAGCAG-1	c2:aneuploid:low.conf
GCGATTGTTAACGTTA-1	c1:diploid:low.conf
GCGCAAATATATTCAA-1	c2:aneuploid:low.conf
GCGCAAGAGCGCGCTG-1	c2:aneuploid:low.conf
GCGCATCCAGTCAGCA-1	c2:aneuploid:low.conf
GCGCCGTTCCACGATA-1	c2:aneuploid:low.conf
GCGCCTCCCACTCCGA-1	c2:aneuploid:low.conf
GCGCGATGGGTCAAGT-1	c2:aneuploid:low.conf
GCGCGGTCTAGTAACT-1	c2:aneuploid:low.conf
GCGCGTCATTGGTACA-1	c2:aneuploid:low.conf
GCGCTAAGTATGCATG-1	c1:diploid:low.conf
GCGCTAATTGAATAGA-1	c2:aneuploid:low.conf
GCGCTATGCCGAGGCA-1	c2:aneuploid:low.conf
GCGCTCGATCACCTGT-1	c2:aneuploid:low.conf
GCGCTGATCCAGACTC-1	c2:aneuploid:low.conf
GCGCTGCTTTGCATTT-1	c2:aneuploid:low.conf
GCGCTTAAATAATTGG-1	c2:aneuploid:low.conf
GCGGACCGCGTTGTGG-1	c2:aneuploid:low.conf
GCGGAGAAACTTCGCA-1	c2:aneuploid:low.conf
GCGGAGAGGGAGAACG-1	c2:aneuploid:low.conf
GCGGCAAAGTATTGCC-1	c2:aneuploid:low.conf
GCGGCTCTGACGTACC-1	c2:aneuploid:low.conf
GCGGCTTTAGCAAGTT-1	c2:aneuploid:low.conf
GCGGGAACCAGGCCCT-1	c2:aneuploid:low.conf
GCGGGCAGACGGGTGA-1	c2:aneuploid:low.conf
GCGGGCATTACGATGC-1	c2:aneuploid:low.conf
GCGGGCGAGCCTTACC-1	c2:aneuploid:low.conf
GCGGTAACCCAAATGA-1	c2:aneuploid:low.conf
GCGGTCCCGGTGAAGG-1	c2:aneuploid:low.conf
GCGGTCCCTAGACGCA-1	c2:aneuploid:low.conf
GCGGTGAACTGCGCTC-1	c2:aneuploid:low.conf
GCGGTTCCCTATCATG-1	c2:aneuploid:low.conf
GCGTAAATGGCCATAA-1	c2:aneuploid:low.conf
GCGTCCAGCTCGTGGC-1	c2:aneuploid:low.conf
GCGTCCCTAAGACATA-1	c2:aneuploid:low.conf
GCGTCGAAATGTCGGT-1	c2:aneuploid:low.conf
GCGTCGCCAGGGTGAT-1	c2:aneuploid:low.conf
GCGTCGTAACATGGTC-1	c2:aneuploid:low.conf
GCGTCTAACCTCCTAA-1	c2:aneuploid:low.conf
GCGTCTCTGCATTGGG-1	c2:aneuploid:low.conf
GCGTGGTACTGGGTTA-1	c2:aneuploid:low.conf
GCGTGTATGTCGTATT-1	c2:aneuploid:low.conf
GCGTTCGGAGACCGGG-1	c1:diploid:low.conf
GCTAAACCTGAGGTGA-1	c2:aneuploid:low.conf
GCTAACTGAAGTCTGA-1	c2:aneuploid:low.conf
GCTAAGTAAAGGCGAT-1	c2:aneuploid:low.conf
GCTAAGTAGTTTCTCT-1	c2:aneuploid:low.conf
GCTAATACCGAATGCC-1	c2:aneuploid:low.conf
GCTACAATCGAGGATA-1	c2:aneuploid:low.conf
GCTACGACTTATTGGG-1	c2:aneuploid:low.conf
GCTACTATAGTAGAGT-1	c2:aneuploid:low.conf
GCTAGACCGTCTACTG-1	c2:aneuploid:low.conf
GCTAGAGTAGAGATGT-1	c2:aneuploid:low.conf
GCTAGCACCTGGGCCA-1	c2:aneuploid:low.conf
GCTAGCAGGGAGTGGG-1	c2:aneuploid:low.conf
GCTAGCGATAGGTCTT-1	c1:diploid:low.conf
GCTAGCTTGAATAGCT-1	c2:aneuploid:low.conf
GCTAGGCACCACGGAG-1	c2:aneuploid:low.conf
GCTAGTAGAGCTTGTA-1	c2:aneuploid:low.conf
GCTAGTTTCATTGAGG-1	c2:aneuploid:low.conf
GCTATACGTCTCGGAC-1	c2:aneuploid:low.conf
GCTATCATACTCATGG-1	c2:aneuploid:low.conf
GCTATCGCGGCGCAAC-1	c2:aneuploid:low.conf
GCTCAATCCGTTTATT-1	c1:diploid:low.conf
GCTCAATGTAATACCG-1	c2:aneuploid:low.conf
GCTCATTACTGCATGT-1	c2:aneuploid:low.conf
GCTCATTGATCATATC-1	c2:aneuploid:low.conf
GCTCCATGCAAAGCAA-1	c2:aneuploid:low.conf
GCTCCCAGTCGGTCCA-1	c2:aneuploid:low.conf
GCTCCGCTCGCTTCAG-1	c2:aneuploid:low.conf
GCTCCTGACATACTGG-1	c2:aneuploid:low.conf
GCTCGCGGTTCCGCTC-1	c2:aneuploid:low.conf
GCTCGCTCATGTCCAA-1	c2:aneuploid:low.conf
GCTCGGAATTTAAAGC-1	c2:aneuploid:low.conf
GCTCTAAACCCTGACG-1	c2:aneuploid:low.conf
GCTCTCGGGTACCGAA-1	c2:aneuploid:low.conf
GCTCTTTCCGCTAGTG-1	c2:aneuploid:low.conf
GCTGAACTCTCCAGGG-1	c2:aneuploid:low.conf
GCTGAGGCGTGAGTAT-1	c2:aneuploid:low.conf
GCTGCACGGTTTCTTA-1	c2:aneuploid:low.conf
GCTGCGAAGAATTATT-1	c1:diploid:low.conf
GCTGCTAAGTAGTCGA-1	c2:aneuploid:low.conf
GCTGCTACTGCGTAGC-1	c2:aneuploid:low.conf
GCTGCTCTCCGGACAC-1	c2:aneuploid:low.conf
GCTGGACCCAAAGTGG-1	c2:aneuploid:low.conf
GCTGGCATATTCACCT-1	c2:aneuploid:low.conf
GCTGGCGGCGCATGCT-1	c2:aneuploid:low.conf
GCTGGGAGCGCGTCAA-1	c2:aneuploid:low.conf
GCTGGGTCCGCTGTTA-1	c2:aneuploid:low.conf
GCTGGTGACTCGTAGT-1	c2:aneuploid:low.conf
GCTGTATTACTGGCCC-1	c2:aneuploid:low.conf
GCTGTTGCTACCGAAC-1	c2:aneuploid:low.conf
GCTTAATGTAACTAAC-1	c2:aneuploid:low.conf
GCTTACGTAGTTAGTA-1	c2:aneuploid:low.conf
GCTTAGGGAAGCGGTA-1	c2:aneuploid:low.conf
GCTTATGAAGCAGGAA-1	c2:aneuploid:low.conf
GCTTCAGTGGGATTAC-1	c2:aneuploid:low.conf
GCTTCCAGCTTAGATT-1	c1:diploid:low.conf
GCTTCCGTCCCTAGAC-1	c2:aneuploid:low.conf
GCTTGATGATAATCAG-1	c2:aneuploid:low.conf
GCTTGCAGCACAATTG-1	c2:aneuploid:low.conf
GCTTGGATCGATTAGG-1	c2:aneuploid:low.conf
GCTTTACACAACTGGG-1	c1:diploid:low.conf
GCTTTATTAAGTTACC-1	c2:aneuploid:low.conf
GCTTTCAGAGGAGGTG-1	c2:aneuploid:low.conf
GCTTTCTATCTCAACT-1	c2:aneuploid:low.conf
GGAAACAGAGCTTGGG-1	c2:aneuploid:low.conf
GGAAACCTTGTTGAAT-1	c2:aneuploid:low.conf
GGAAACTAAATGGGCC-1	c2:aneuploid:low.conf
GGAAAGGGAATTGAGC-1	c2:aneuploid:low.conf
GGAAAGTCTTGATTGT-1	c2:aneuploid:low.conf
GGAAAGTGCCCATGCC-1	c2:aneuploid:low.conf
GGAACCGTGTAAATTG-1	c2:aneuploid:low.conf
GGAACGGCCTGCAGCC-1	c2:aneuploid:low.conf
GGAACTCGTGAATACG-1	c1:diploid:low.conf
GGAAGATAAGACTGTA-1	c2:aneuploid:low.conf
GGAAGCTCGCTTACAG-1	c2:aneuploid:low.conf
GGAATAACCTCAAGAA-1	c2:aneuploid:low.conf
GGAATGCGCTAGCGTG-1	c2:aneuploid:low.conf
GGACAACCATGAAGCC-1	c1:diploid:low.conf
GGACACAAGTTTACAC-1	c2:aneuploid:low.conf
GGACACCTCGGTGTTG-1	c2:aneuploid:low.conf
GGACCAACAGGATAAC-1	c2:aneuploid:low.conf
GGACCTACGGTAACGT-1	c2:aneuploid:low.conf
GGACCTCTAGGCCGCC-1	c2:aneuploid:low.conf
GGACGGCTTGCGCAAC-1	c2:aneuploid:low.conf
GGACGTCCATAGTTGG-1	c2:aneuploid:low.conf
GGACTCACAAATTAGG-1	c1:diploid:low.conf
GGACTCGACAGCGCAT-1	c2:aneuploid:low.conf
GGACTCGTGAGTGGTC-1	c1:diploid:low.conf
GGACTCTTTGACTAAG-1	c2:aneuploid:low.conf
GGAGACCAATGTGCTT-1	c2:aneuploid:low.conf
GGAGACGACACCTTTG-1	c2:aneuploid:low.conf
GGAGCAACATTTCAAG-1	c2:aneuploid:low.conf
GGAGCACCAAGAACTA-1	c2:aneuploid:low.conf
GGAGCGAGGCCTACTT-1	c2:aneuploid:low.conf
GGAGGATTGAAAGGAG-1	c2:aneuploid:low.conf
GGAGGCCGAAGTCGTC-1	c2:aneuploid:low.conf
GGAGGGCTTGGTTGGC-1	c2:aneuploid:low.conf
GGAGTGCCGCCCTGGA-1	c2:aneuploid:low.conf
GGAGTTGATTCTGTGT-1	c1:diploid:low.conf
GGATACTCATGAATTG-1	c2:aneuploid:low.conf
GGATCAAAGGACGAGG-1	c2:aneuploid:low.conf
GGATCATCCCGTACGC-1	c1:diploid:low.conf
GGATCCGGAATATACT-1	c1:diploid:low.conf
GGATCTACCGTTCGTC-1	c2:aneuploid:low.conf
GGATCTTACTGCCCTT-1	c1:diploid:low.conf
GGATGAAGATCGCTGA-1	c2:aneuploid:low.conf
GGATGACGCGAGTTTA-1	c2:aneuploid:low.conf
GGATGGCTTGAAGTAT-1	c1:diploid:low.conf
GGATGTCCTTACCGCA-1	c2:aneuploid:low.conf
GGATTAAGCTAAGGTC-1	c2:aneuploid:low.conf
GGATTAATCATGGACC-1	c2:aneuploid:low.conf
GGATTCAGTACGGTGG-1	c2:aneuploid:low.conf
GGATTCCGCTATACCC-1	c2:aneuploid:low.conf
GGATTGCTGTGACTCC-1	c2:aneuploid:low.conf
GGATTTCACTTCTATA-1	c2:aneuploid:low.conf
GGCAAAGGCGCCAATA-1	c2:aneuploid:low.conf
GGCAAATTACTTTACT-1	c2:aneuploid:low.conf
GGCAAGCCAGGGATAG-1	c2:aneuploid:low.conf
GGCAAGCCCATAGTGG-1	c2:aneuploid:low.conf
GGCAAGGCGAAATAGC-1	c2:aneuploid:low.conf
GGCAATAGTCAATGAG-1	c2:aneuploid:low.conf
GGCACGCTGCTACAGT-1	c1:diploid:low.conf
GGCACTCCACTGGGCA-1	c2:aneuploid:low.conf
GGCACTGCGGTGGTTT-1	c1:diploid:low.conf
GGCAGCAAACCTATGC-1	c2:aneuploid:low.conf
GGCAGCGGTAATCCTA-1	c2:aneuploid:low.conf
GGCATACAGGTAGCGG-1	c2:aneuploid:low.conf
GGCATATCGGTTCTGC-1	c2:aneuploid:low.conf
GGCATCAACGAGCACG-1	c2:aneuploid:low.conf
GGCATTGAACATCTCA-1	c2:aneuploid:low.conf
GGCCACAAGCGATGGC-1	c2:aneuploid:low.conf
GGCCCAATCTAGAGGG-1	c2:aneuploid:low.conf
GGCCCAGCTGGTTTGC-1	c2:aneuploid:low.conf
GGCCCAGTTATCAGCA-1	c2:aneuploid:low.conf
GGCCCGGAGCATGTCT-1	c1:diploid:low.conf
GGCCCGTATACCATGC-1	c2:aneuploid:low.conf
GGCCGAGACTCTGGTG-1	c1:diploid:low.conf
GGCCGCAGGAACCGCA-1	c1:diploid:low.conf
GGCCGGCGTCTGCTAT-1	c2:aneuploid:low.conf
GGCCGTTTGGGTTTCA-1	c2:aneuploid:low.conf
GGCCTGCTCTGATGTT-1	c2:aneuploid:low.conf
GGCCTGCTTCTCCCGA-1	c2:aneuploid:low.conf
GGCGAAATCTAACTTG-1	c2:aneuploid:low.conf
GGCGAACCGTTCTGAT-1	c2:aneuploid:low.conf
GGCGCATGAATTGATG-1	c2:aneuploid:low.conf
GGCGCGGAGATCTTTC-1	c2:aneuploid:low.conf
GGCGCGTTCGAGTTTA-1	c2:aneuploid:low.conf
GGCGCTCCTCATCAAT-1	c2:aneuploid:low.conf
GGCGCTTCATTCCCTG-1	c2:aneuploid:low.conf
GGCGGAGTAATATTAG-1	c2:aneuploid:low.conf
GGCGGTAGGATCATTG-1	c2:aneuploid:low.conf
GGCGTACCCTATATAA-1	c2:aneuploid:low.conf
GGCGTAGGGAAAGCTG-1	c2:aneuploid:low.conf
GGCGTCCTATCCGCTG-1	c2:aneuploid:low.conf
GGCTAAAGGGCGGGTC-1	c1:diploid:low.conf
GGCTAATGATTGAAAT-1	c2:aneuploid:low.conf
GGCTACTATACACTCC-1	c2:aneuploid:low.conf
GGCTATTAAGTTGTAT-1	c2:aneuploid:low.conf
GGCTCCTCCACCTGTT-1	c2:aneuploid:low.conf
GGCTCGCGTTGAGGTA-1	c2:aneuploid:low.conf
GGCTCGTGCCACCAGC-1	c2:aneuploid:low.conf
GGCTCTGCTCCAACGC-1	c2:aneuploid:low.conf
GGCTGAAATAGCAAAG-1	c2:aneuploid:low.conf
GGCTGAGCATCGTAAG-1	c2:aneuploid:low.conf
GGCTGGCTAGCTTAAA-1	c2:aneuploid:low.conf
GGCTGTCCTACTGCGG-1	c2:aneuploid:low.conf
GGCTTTCAATAAGGGT-1	c2:aneuploid:low.conf
GGGAAAGAATGCCAAC-1	c1:diploid:low.conf
GGGAACCACCTGTTTC-1	c2:aneuploid:low.conf
GGGAACGGGAGGTTAG-1	c2:aneuploid:low.conf
GGGAACGGTTTCAGAT-1	c1:diploid:low.conf
GGGAAGACGGTCTGTC-1	c2:aneuploid:low.conf
GGGAAGGGCTTTCTCA-1	c1:diploid:low.conf
GGGAATGAGCCCTCAC-1	c2:aneuploid:low.conf
GGGACCCGTATATCTT-1	c2:aneuploid:low.conf
GGGACTGCATAGATAG-1	c2:aneuploid:low.conf
GGGAGAACTCACAGTA-1	c2:aneuploid:low.conf
GGGAGCGACCGTAGTG-1	c2:aneuploid:low.conf
GGGAGGATGCCCGAAA-1	c2:aneuploid:low.conf
GGGAGTAATGGCTGGC-1	c2:aneuploid:low.conf
GGGAGTTAATGAGGCG-1	c2:aneuploid:low.conf
GGGATATTGATCGCCA-1	c2:aneuploid:low.conf
GGGATCCCAATACAAA-1	c2:aneuploid:low.conf
GGGATGGTCGTAACCG-1	c2:aneuploid:low.conf
GGGATTTACCGCACCT-1	c2:aneuploid:low.conf
GGGCACGTAGTACTGT-1	c2:aneuploid:low.conf
GGGCAGAGCAATCGTT-1	c2:aneuploid:low.conf
GGGCAGTCAACGCCAA-1	c2:aneuploid:low.conf
GGGCATGCATGTCGAG-1	c2:aneuploid:low.conf
GGGCCCGTCTTAAACA-1	c2:aneuploid:low.conf
GGGCCGGCCGAAGTAC-1	c2:aneuploid:low.conf
GGGCCTATTTAAGTAT-1	c2:aneuploid:low.conf
GGGCGATATGTGTGAA-1	c2:aneuploid:low.conf
GGGCGCAGCGTTACTC-1	c2:aneuploid:low.conf
GGGCGGCAAATGAATT-1	c2:aneuploid:low.conf
GGGCGGGTTCCCTACG-1	c2:aneuploid:low.conf
GGGCGGTCCTATTGTC-1	c2:aneuploid:low.conf
GGGCGTACATTTATAT-1	c2:aneuploid:low.conf
GGGCGTCACCACGTAA-1	c2:aneuploid:low.conf
GGGCGTCCACTGGCTC-1	c2:aneuploid:low.conf
GGGCGTGGTTTCCCAG-1	c2:aneuploid:low.conf
GGGCGTTTACATTCAT-1	c1:diploid:low.conf
GGGCTATGATCGATGG-1	c2:aneuploid:low.conf
GGGCTCATCGAACCCA-1	c2:aneuploid:low.conf
GGGCTGCCTAGGGCGA-1	c2:aneuploid:low.conf
GGGCTGGTTAGTCGCG-1	c1:diploid:low.conf
GGGTACCCACGGTCCT-1	c2:aneuploid:low.conf
GGGTACTTCATGAACT-1	c2:aneuploid:low.conf
GGGTATGTATGCACTT-1	c2:aneuploid:low.conf
GGGTCACCGTGACGGT-1	c2:aneuploid:low.conf
GGGTCAGGAGCTAGAT-1	c2:aneuploid:low.conf
GGGTCATGCGTACCAT-1	c2:aneuploid:low.conf
GGGTCGTGGCAAGTGT-1	c2:aneuploid:low.conf
GGGTGACACCTTAACT-1	c2:aneuploid:low.conf
GGGTGCATATGAAAGC-1	c2:aneuploid:low.conf
GGGTGGTCCAGCCTGT-1	c2:aneuploid:low.conf
GGGTGTTTCAGCTATG-1	c2:aneuploid:low.conf
GGGTTAACATTTGAGT-1	c2:aneuploid:low.conf
GGGTTCAGACGAACAA-1	c2:aneuploid:low.conf
GGGTTTAGGATAGGAT-1	c2:aneuploid:low.conf
GGTAAATGTGCGTTAC-1	c2:aneuploid:low.conf
GGTAACCGGGAGGATA-1	c2:aneuploid:low.conf
GGTAACTATGTATCTG-1	c2:aneuploid:low.conf
GGTACAAACATGCTAT-1	c2:aneuploid:low.conf
GGTACACCAGATTTAT-1	c2:aneuploid:low.conf
GGTACCATTAAGACGG-1	c1:diploid:low.conf
GGTACTAAGTGCTTTG-1	c2:aneuploid:low.conf
GGTAGAAGACCGCCTG-1	c2:aneuploid:low.conf
GGTAGACCGTTGGGCG-1	c2:aneuploid:low.conf
GGTAGGCCAATATCAC-1	c2:aneuploid:low.conf
GGTAGTGCTCGCACCA-1	c2:aneuploid:low.conf
GGTATAGTGACACATA-1	c2:aneuploid:low.conf
GGTATTGCCGAGTTTA-1	c2:aneuploid:low.conf
GGTCAAGACTACTTCG-1	c2:aneuploid:low.conf
GGTCAGTGGGTCCCAC-1	c2:aneuploid:low.conf
GGTCATTGTAGTCATA-1	c2:aneuploid:low.conf
GGTCCACGTCTATTTG-1	c2:aneuploid:low.conf
GGTCGGATAAACGGCG-1	c1:diploid:low.conf
GGTCGGCCAGGAGCTT-1	c2:aneuploid:low.conf
GGTCGGTAATTAGACA-1	c2:aneuploid:low.conf
GGTCGGTCGTCCACAG-1	c2:aneuploid:low.conf
GGTCTCCAAGTAGTGC-1	c2:aneuploid:low.conf
GGTCTCCGTCCAGGTT-1	c1:diploid:low.conf
GGTCTCTGAATGGACT-1	c2:aneuploid:low.conf
GGTCTGAGAATCTGGA-1	c2:aneuploid:low.conf
GGTCTTGAGCGCTCTT-1	c2:aneuploid:low.conf
GGTGAAACCGGGAATG-1	c2:aneuploid:low.conf
GGTGAACGGGCTAGCC-1	c2:aneuploid:low.conf
GGTGAAGTACAGGGAT-1	c1:diploid:low.conf
GGTGAGATGCAGATAA-1	c2:aneuploid:low.conf
GGTGATAAGGAGCAGT-1	c2:aneuploid:low.conf
GGTGATTTCATCTTGT-1	c2:aneuploid:low.conf
GGTGCAGAGCCTATCG-1	c2:aneuploid:low.conf
GGTGCATAAATGATTA-1	c2:aneuploid:low.conf
GGTGCGGATAAGTGGC-1	c2:aneuploid:low.conf
GGTGCTGATCACAAAG-1	c2:aneuploid:low.conf
GGTGCTGGTACACATT-1	c2:aneuploid:low.conf
GGTGGACCACGTGTTA-1	c2:aneuploid:low.conf
GGTGGACTGCTCTGGC-1	c2:aneuploid:low.conf
GGTGGAGGTTGATACG-1	c2:aneuploid:low.conf
GGTGGGATTAGGTCCC-1	c2:aneuploid:low.conf
GGTGTAAATCGATTGT-1	c2:aneuploid:low.conf
GGTGTAGGTAAGTAAA-1	c2:aneuploid:low.conf
GGTGTTCTGTTTCTAC-1	c2:aneuploid:low.conf
GGTGTTGGGCGTCTTA-1	c2:aneuploid:low.conf
GGTTACCCGACACTTT-1	c2:aneuploid:low.conf
GGTTACCGCTCCCTAC-1	c1:diploid:low.conf
GGTTAGCTATATGTCT-1	c2:aneuploid:low.conf
GGTTAGGCTTGGAGAA-1	c1:diploid:low.conf
GGTTAGTTACGGCGCC-1	c2:aneuploid:low.conf
GGTTCCCTAGTGTCTC-1	c2:aneuploid:low.conf
GGTTCCGTACGACTAA-1	c1:diploid:low.conf
GGTTCGATGCTGAGTT-1	c2:aneuploid:low.conf
GGTTCTACTCGTCTGA-1	c2:aneuploid:low.conf
GGTTGTATCGTGAAAT-1	c2:aneuploid:low.conf
GGTTTAATTACCATCG-1	c1:diploid:low.conf
GGTTTAATTGAGCAGG-1	c2:aneuploid:low.conf
GGTTTACAATCTCAAT-1	c2:aneuploid:low.conf
GGTTTAGCCTTTCTTG-1	c2:aneuploid:low.conf
GGTTTCAATCGGTCAG-1	c2:aneuploid:low.conf
GGTTTGACAAGAAGCT-1	c2:aneuploid:low.conf
GGTTTGAGTGCTGGAA-1	c2:aneuploid:low.conf
GGTTTGCGAACACGTA-1	c2:aneuploid:low.conf
GGTTTGTGACCTGAGG-1	c2:aneuploid:low.conf
GTAACAACTGACCTTG-1	c2:aneuploid:low.conf
GTAACAGGTTAACGGC-1	c1:diploid:low.conf
GTAACATCTAAGATAA-1	c2:aneuploid:low.conf
GTAACTACGTAGACCT-1	c2:aneuploid:low.conf
GTAACTGCCCAAGGAG-1	c2:aneuploid:low.conf
GTAACTTGCGGCAGTC-1	c2:aneuploid:low.conf
GTAAGCGGGCAGTCAG-1	c2:aneuploid:low.conf
GTAAGGATTTGTCGGA-1	c2:aneuploid:low.conf
GTAAGTAACAGTCTGG-1	c2:aneuploid:low.conf
GTAAGTAGGGTATACC-1	c2:aneuploid:low.conf
GTAAGTCCACACTCTA-1	c1:diploid:low.conf
GTAATAAAGGGCTCCC-1	c2:aneuploid:low.conf
GTAATCTGATTCTTCG-1	c2:aneuploid:low.conf
GTACACTTACCTGAAG-1	c2:aneuploid:low.conf
GTACAGAGGCAAGGGT-1	c2:aneuploid:low.conf
GTACGACGGCGCTGCG-1	c2:aneuploid:low.conf
GTACGAGATTGCGACA-1	c2:aneuploid:low.conf
GTACGCTTCATTGCAC-1	c2:aneuploid:low.conf
GTACGTCACGTATTAA-1	c2:aneuploid:low.conf
GTACGTTTGCCCGTCA-1	c1:diploid:low.conf
GTACTAAGATTTGGAG-1	c2:aneuploid:low.conf
GTACTCCTGGGTATGC-1	c2:aneuploid:low.conf
GTACTGAGGTCGTAAC-1	c2:aneuploid:low.conf
GTACTGCATGAAGCGT-1	c2:aneuploid:low.conf
GTACTGGAGTTAGACC-1	c2:aneuploid:low.conf
GTACTTGGGCACTTCT-1	c2:aneuploid:low.conf
GTAGAAACGGGTGGAG-1	c2:aneuploid:low.conf
GTAGACAACCGATGAA-1	c2:aneuploid:low.conf
GTAGACACGCCTGACT-1	c2:aneuploid:low.conf
GTAGACGTCGTTACAT-1	c2:aneuploid:low.conf
GTAGAGGGAGACAAGT-1	c2:aneuploid:low.conf
GTAGCCAAACATGGGA-1	c2:aneuploid:low.conf
GTAGCGCTGTTGTAGT-1	c2:aneuploid:low.conf
GTAGCGGCTATACACT-1	c2:aneuploid:low.conf
GTAGCTAGTAAGCGCG-1	c2:aneuploid:low.conf
GTAGCTCCGGGAGGCT-1	c2:aneuploid:low.conf
GTAGCTTCCTCTTGTT-1	c2:aneuploid:low.conf
GTAGGTGATCCGTGTA-1	c2:aneuploid:low.conf
GTAGTCGCGGGAATCA-1	c2:aneuploid:low.conf
GTAGTCTACGATATTG-1	c2:aneuploid:low.conf
GTAGTGAGCAACCTCA-1	c1:diploid:low.conf
GTAGTTCGAAGGCGAA-1	c2:aneuploid:low.conf
GTAGTTTAAGCACACG-1	c2:aneuploid:low.conf
GTATAATCTCCCGGAT-1	c2:aneuploid:low.conf
GTATAGGACTCAGTAG-1	c2:aneuploid:low.conf
GTATAGTGGCCCATGT-1	c2:aneuploid:low.conf
GTATCAAACGTTAGCT-1	c2:aneuploid:low.conf
GTATCAAGGTACTTCC-1	c2:aneuploid:low.conf
GTATCAGCTTGGGTTC-1	c2:aneuploid:low.conf
GTATCCTTTGGTAACC-1	c1:diploid:low.conf
GTATCGGGACGAGCTG-1	c2:aneuploid:low.conf
GTATCTCCCTAACTGT-1	c2:aneuploid:low.conf
GTATCTTGTTGCTCAC-1	c2:aneuploid:low.conf
GTATCTTTCATAACCA-1	c2:aneuploid:low.conf
GTATGACGTGGGAAAC-1	c2:aneuploid:low.conf
GTATGTGGGTCTAGTT-1	c2:aneuploid:low.conf
GTATTAAGGCGTCTAA-1	c2:aneuploid:low.conf
GTATTAGGGTTCGCGT-1	c2:aneuploid:low.conf
GTATTCTGAGAAACGA-1	c1:diploid:low.conf
GTATTTAATGGCATAA-1	c2:aneuploid:low.conf
GTCAAAGTTTACATAG-1	c2:aneuploid:low.conf
GTCAACCAGGCCTATA-1	c1:diploid:low.conf
GTCAAGCGGACTCGGG-1	c2:aneuploid:low.conf
GTCAATGCTATAATTT-1	c2:aneuploid:low.conf
GTCAATTGTACTGAAG-1	c2:aneuploid:low.conf
GTCACAAAGTTTCCAA-1	c2:aneuploid:low.conf
GTCACTCTCCAAATCT-1	c2:aneuploid:low.conf
GTCAGAATAGTCTATG-1	c2:aneuploid:low.conf
GTCAGTTGTGCTCGTT-1	c2:aneuploid:low.conf
GTCATCCCAAACTCAC-1	c2:aneuploid:low.conf
GTCATGCACCTCCGTT-1	c1:diploid:low.conf
GTCATGCGCGAGGGCT-1	c1:diploid:low.conf
GTCATGGACATGACTA-1	c2:aneuploid:low.conf
GTCATTAGAGCGAACG-1	c2:aneuploid:low.conf
GTCCAATATTTAGCCT-1	c2:aneuploid:low.conf
GTCCAGGCACGTGTGC-1	c2:aneuploid:low.conf
GTCCATTACTGCTACG-1	c2:aneuploid:low.conf
GTCCCAACGTAAAGTA-1	c2:aneuploid:low.conf
GTCCCGCGACGTTATG-1	c2:aneuploid:low.conf
GTCCGGACCTGAAATT-1	c2:aneuploid:low.conf
GTCCGGCTGAATTGCG-1	c1:diploid:low.conf
GTCCGGGTTCACATTA-1	c2:aneuploid:low.conf
GTCCGTTAGAGGGCCT-1	c2:aneuploid:low.conf
GTCCTACAGGCGGCTC-1	c2:aneuploid:low.conf
GTCCTACGAATAGTCT-1	c2:aneuploid:low.conf
GTCCTTCTAGTGGGTT-1	c2:aneuploid:low.conf
GTCCTTTAATGACTTC-1	c2:aneuploid:low.conf
GTCGATAGGTGACTTT-1	c2:aneuploid:low.conf
GTCGCCGTTGTGTGTT-1	c1:diploid:low.conf
GTCGCGTAACCCGTTG-1	c2:aneuploid:low.conf
GTCGGAAGGATACCAG-1	c2:aneuploid:low.conf
GTCGGATATCTCAGAC-1	c2:aneuploid:low.conf
GTCGGATGTAGCGCGC-1	c2:aneuploid:low.conf
GTCGGGAAGCAGAAAC-1	c2:aneuploid:low.conf
GTCGTACCATCTCGGG-1	c2:aneuploid:low.conf
GTCGTATTGGCGTACA-1	c2:aneuploid:low.conf
GTCGTCAATTATAAGG-1	c2:aneuploid:low.conf
GTCGTCTGGTTGGCTA-1	c2:aneuploid:low.conf
GTCGTGTCTGGTCATC-1	c1:diploid:low.conf
GTCGTTATTCGCTTAT-1	c2:aneuploid:low.conf
GTCTAGTGAGCCGCTT-1	c2:aneuploid:low.conf
GTCTATACACGCATGG-1	c2:aneuploid:low.conf
GTCTATCTGAGTTTCT-1	c2:aneuploid:low.conf
GTCTATTGCATGCTCG-1	c1:diploid:low.conf
GTCTATTGGTTCCGGT-1	c2:aneuploid:low.conf
GTCTCAAGGCCCGGCT-1	c2:aneuploid:low.conf
GTCTCCCGAGTCCCGT-1	c2:aneuploid:low.conf
GTCTCGACTAAGTTTG-1	c2:aneuploid:low.conf
GTCTCGATCTGCTTTC-1	c2:aneuploid:low.conf
GTCTCGCCAACACGCC-1	c2:aneuploid:low.conf
GTCTGGGCGGTCGAGA-1	c2:aneuploid:low.conf
GTCTGTAGGTTGAACA-1	c1:diploid:low.conf
GTCTTAGTACAGCCGG-1	c2:aneuploid:low.conf
GTCTTGAGGAGCAGTG-1	c2:aneuploid:low.conf
GTCTTGTAGCTATTCA-1	c2:aneuploid:low.conf
GTGAAACGGCGCCACC-1	c2:aneuploid:low.conf
GTGAAACGTGCTCCAC-1	c2:aneuploid:low.conf
GTGAACTCCCATTCGA-1	c2:aneuploid:low.conf
GTGAAGATTTCAAGTG-1	c1:diploid:low.conf
GTGAAGCCGTATAGTC-1	c2:aneuploid:low.conf
GTGACAGCTTCCCACT-1	c2:aneuploid:low.conf
GTGACCGCACACTACG-1	c2:aneuploid:low.conf
GTGACCTAAAGAATAA-1	c2:aneuploid:low.conf
GTGACGAGGGTGACCC-1	c2:aneuploid:low.conf
GTGACGCAGGTTTCAT-1	c2:aneuploid:low.conf
GTGACTTCAGTAGTGC-1	c2:aneuploid:low.conf
GTGAGATAACCTTATA-1	c2:aneuploid:low.conf
GTGAGGACACTTAAGG-1	c2:aneuploid:low.conf
GTGAGGAGCGGTTGAG-1	c2:aneuploid:low.conf
GTGAGTCGACTAATAG-1	c1:diploid:low.conf
GTGAGTGGTACAACGC-1	c2:aneuploid:low.conf
GTGATCAAGCGTGCAC-1	c2:aneuploid:low.conf
GTGATCACTAACGCCT-1	c2:aneuploid:low.conf
GTGATCATAGATCTGC-1	c2:aneuploid:low.conf
GTGATCCTTGTCATGA-1	c2:aneuploid:low.conf
GTGATGCACAACATCT-1	c2:aneuploid:low.conf
GTGATTCGCCGCTCAA-1	c1:diploid:low.conf
GTGCAACAAATGTGGC-1	c2:aneuploid:low.conf
GTGCACCAGCTTCAAC-1	c2:aneuploid:low.conf
GTGCACGAAAGTGACT-1	c2:aneuploid:low.conf
GTGCAGCGTAGAGTAG-1	c2:aneuploid:low.conf
GTGCCAAACGTTTCGA-1	c1:diploid:low.conf
GTGCCCGTTCGGATTC-1	c2:aneuploid:low.conf
GTGCCGCTTCAAAGGT-1	c2:aneuploid:low.conf
GTGCCTCAGTGTACGG-1	c2:aneuploid:low.conf
GTGCCTGAGACCAAAC-1	c2:aneuploid:low.conf
GTGCGAAATCGAACAC-1	c2:aneuploid:low.conf
GTGCGACAGGGAGTGT-1	c2:aneuploid:low.conf
GTGCGCTTACAAATGA-1	c2:aneuploid:low.conf
GTGCGGGTCTCCAAAT-1	c2:aneuploid:low.conf
GTGCGTGTATATGAGC-1	c2:aneuploid:low.conf
GTGCTATCCAGCTGGA-1	c2:aneuploid:low.conf
GTGCTCAAGTACTGTC-1	c2:aneuploid:low.conf
GTGCTTACATCAGCGC-1	c2:aneuploid:low.conf
GTGGAACCTACATGCG-1	c2:aneuploid:low.conf
GTGGACGCATTTGTCC-1	c2:aneuploid:low.conf
GTGGACGTGCTGAGAC-1	c2:aneuploid:low.conf
GTGGAGCATGTCGGCC-1	c2:aneuploid:low.conf
GTGGAGTCGGCGGTTG-1	c1:diploid:low.conf
GTGGCGGGCCGTAGCT-1	c2:aneuploid:low.conf
GTGGCTGTTTCTGTTC-1	c2:aneuploid:low.conf
GTGGGAACAAACCGGG-1	c2:aneuploid:low.conf
GTGGGCTTAGACACAC-1	c2:aneuploid:low.conf
GTGGGTCTTCTTTGCG-1	c2:aneuploid:low.conf
GTGGTATAGTCTGCCG-1	c1:diploid:low.conf
GTGGTCAGCGAAGTAT-1	c2:aneuploid:low.conf
GTGGTGGCCAAGTGAA-1	c2:aneuploid:low.conf
GTGGTTACTTCTTTCG-1	c1:diploid:low.conf
GTGTACCTTGGCTACG-1	c2:aneuploid:low.conf
GTGTACGAACCGTTCC-1	c2:aneuploid:low.conf
GTGTATATCAGCGGGC-1	c2:aneuploid:low.conf
GTGTATGACTTTAAAG-1	c2:aneuploid:low.conf
GTGTCAGTGTACGTGG-1	c2:aneuploid:low.conf
GTGTCGTATAGCGTTC-1	c2:aneuploid:low.conf
GTGTCGTATTCACCTT-1	c2:aneuploid:low.conf
GTGTGAATAACTTAGG-1	c2:aneuploid:low.conf
GTGTGAGCCGAGGTGC-1	c2:aneuploid:low.conf
GTGTTACTATGCGTCC-1	c2:aneuploid:low.conf
GTTAAAGTAGGACTGG-1	c2:aneuploid:low.conf
GTTAACATCACTTAAA-1	c2:aneuploid:low.conf
GTTAACTATGTTGTCA-1	c2:aneuploid:low.conf
GTTAAGGGTGCGATGT-1	c2:aneuploid:low.conf
GTTAAGTTAGAGTGGG-1	c2:aneuploid:low.conf
GTTACCTACAACTTGC-1	c2:aneuploid:low.conf
GTTACGAAATCCACGC-1	c2:aneuploid:low.conf
GTTACGGCCCGACTGC-1	c2:aneuploid:low.conf
GTTACTTTGGGCCTAG-1	c2:aneuploid:low.conf
GTTAGAGTGTGCCGCT-1	c2:aneuploid:low.conf
GTTAGCCCATGACATC-1	c2:aneuploid:low.conf
GTTAGCCGTAAATCAA-1	c2:aneuploid:low.conf
GTTATAATACGGTGAA-1	c2:aneuploid:low.conf
GTTATATCAGGAGCCA-1	c2:aneuploid:low.conf
GTTATATTATCTCCCT-1	c2:aneuploid:low.conf
GTTATCAAGCTATCGA-1	c1:diploid:low.conf
GTTATCACCTTCTGAA-1	c2:aneuploid:low.conf
GTTATTAAATACGACC-1	c2:aneuploid:low.conf
GTTATTAACGTGGGAG-1	c2:aneuploid:low.conf
GTTCAATCTATGTCAA-1	c2:aneuploid:low.conf
GTTCACAGGAGTCTAG-1	c2:aneuploid:low.conf
GTTCAGTCGCCAAATG-1	c2:aneuploid:low.conf
GTTCATCGTTTGGCTG-1	c1:diploid:low.conf
GTTCCAAGACAGCGAC-1	c2:aneuploid:low.conf
GTTCCAGTCTGACCAT-1	c2:aneuploid:low.conf
GTTCCGTCCGCCTGCA-1	c2:aneuploid:low.conf
GTTCGACAATTGTATA-1	c2:aneuploid:low.conf
GTTCGCCATAAGTGCC-1	c2:aneuploid:low.conf
GTTCGCTGAGACGTCT-1	c2:aneuploid:low.conf
GTTCGGATCGGGAACA-1	c2:aneuploid:low.conf
GTTCGGGCGTACCATT-1	c1:diploid:low.conf
GTTCGTCTAAAGAACT-1	c2:aneuploid:low.conf
GTTCGTCTGGGTCCCT-1	c1:diploid:low.conf
GTTCGTTGCGGACCAG-1	c2:aneuploid:low.conf
GTTCTTCCCTCGATGT-1	c2:aneuploid:low.conf
GTTCTTGTAACTCAAT-1	c2:aneuploid:low.conf
GTTGAACCGGTTCCAT-1	c2:aneuploid:low.conf
GTTGAGTCCCGCCGGT-1	c2:aneuploid:low.conf
GTTGCACGGAGTTTCG-1	c2:aneuploid:low.conf
GTTGCGCTAACATTAC-1	c2:aneuploid:low.conf
GTTGCGGACGGTCAGG-1	c2:aneuploid:low.conf
GTTGGACCGCATCAGG-1	c2:aneuploid:low.conf
GTTGGATTCAGTGGCT-1	c1:diploid:low.conf
GTTGGATTGAGAACAC-1	c2:aneuploid:low.conf
GTTGGATTTGCGTTGG-1	c2:aneuploid:low.conf
GTTGGTCATGCTATCC-1	c2:aneuploid:low.conf
GTTGTAGATTTATGAG-1	c2:aneuploid:low.conf
GTTGTCGTGTTAGTTG-1	c2:aneuploid:low.conf
GTTGTTACATTGCGCT-1	c2:aneuploid:low.conf
GTTTACGTTCCATCTG-1	c2:aneuploid:low.conf
GTTTCCTGGAGGGTGA-1	c2:aneuploid:low.conf
GTTTCTAGAGGCGCGG-1	c2:aneuploid:low.conf
GTTTCTGCAGTCTCCC-1	c2:aneuploid:low.conf
GTTTGACCAAATCCTA-1	c2:aneuploid:low.conf
GTTTGAGCGGTTATGT-1	c2:aneuploid:low.conf
GTTTGGCCCAAGTTAT-1	c2:aneuploid:low.conf
GTTTGGCCGCTCAGCG-1	c2:aneuploid:low.conf
GTTTGGCGTCAGGCAC-1	c1:diploid:low.conf
GTTTGGGCTTGTGAGC-1	c2:aneuploid:low.conf
GTTTGGGTTTCGCCCG-1	c1:diploid:low.conf
GTTTGGTAGGGTCAAC-1	c2:aneuploid:low.conf
GTTTGGTGATCGGTGC-1	c2:aneuploid:low.conf
TAAACCCAGGAGGGCA-1	c2:aneuploid:low.conf
TAAAGACAACCCTTTA-1	c2:aneuploid:low.conf
TAAAGAGCCCGAAACC-1	c2:aneuploid:low.conf
TAAAGCGGTATTTCCA-1	c2:aneuploid:low.conf
TAAAGCGTTAGGAGAA-1	c2:aneuploid:low.conf
TAAAGCTGCAATAGGG-1	c1:diploid:low.conf
TAAAGTGCACGTCTCG-1	c2:aneuploid:low.conf
TAAATCTTTACACCTC-1	c2:aneuploid:low.conf
TAAATGAATCCGTTTC-1	c2:aneuploid:low.conf
TAAATGCCGTCTCATG-1	c2:aneuploid:low.conf
TAAATTGTGGGTAAAG-1	c2:aneuploid:low.conf
TAAATTTAGTAACACC-1	c2:aneuploid:low.conf
TAACAAAGGGAGAAGC-1	c2:aneuploid:low.conf
TAACAATATTTGTTGC-1	c2:aneuploid:low.conf
TAACAGCGTTTGTGCT-1	c1:diploid:low.conf
TAACAGGTTCCCTTAG-1	c2:aneuploid:low.conf
TAACATACAATGTGGG-1	c2:aneuploid:low.conf
TAACATACACGCGATC-1	c2:aneuploid:low.conf
TAACCGCCCGCAGTGC-1	c2:aneuploid:low.conf
TAACCTACCGTCCGAG-1	c2:aneuploid:low.conf
TAACCTAGGGAGTCCA-1	c2:aneuploid:low.conf
TAACGCTTTGAGAGCG-1	c2:aneuploid:low.conf
TAACTATCGAAGGTCC-1	c2:aneuploid:low.conf
TAACTATTACGCCAAA-1	c1:diploid:low.conf
TAACTCATCCGCGCGG-1	c2:aneuploid:low.conf
TAACTCCATGGAGGCT-1	c2:aneuploid:low.conf
TAAGATTTAGCGGGAG-1	c2:aneuploid:low.conf
TAAGCCCTTACGACCA-1	c2:aneuploid:low.conf
TAAGCGCGAATCAAAT-1	c1:diploid:low.conf
TAAGGAACTTGTGGGA-1	c2:aneuploid:low.conf
TAAGGCAACATAAGAT-1	c2:aneuploid:low.conf
TAAGGCATAACATCAA-1	c2:aneuploid:low.conf
TAAGGCCCGTCACCCT-1	c2:aneuploid:low.conf
TAAGGCTGAATCCCTC-1	c2:aneuploid:low.conf
TAAGGGCCTGTCCGAT-1	c2:aneuploid:low.conf
TAAGTAAATGTGCCGC-1	c2:aneuploid:low.conf
TAAGTAACATCTTGAC-1	c2:aneuploid:low.conf
TAAGTCGCCGAGTATC-1	c2:aneuploid:low.conf
TAAGTGAATAGTCTAC-1	c2:aneuploid:low.conf
TAAGTTGCGACGTAGG-1	c2:aneuploid:low.conf
TAATAAACAAGGAGAT-1	c2:aneuploid:low.conf
TAATACACAGTAGTAT-1	c2:aneuploid:low.conf
TAATACTAGAACAGAC-1	c2:aneuploid:low.conf
TAATAGAACAGAGTTA-1	c1:diploid:low.conf
TAATAGCTAAATGATG-1	c2:aneuploid:low.conf
TAATAGTGACGACCAG-1	c2:aneuploid:low.conf
TAATATTGAAATTCGC-1	c2:aneuploid:low.conf
TAATCAACCAAATGGG-1	c2:aneuploid:low.conf
TAATCGATCCGTACGT-1	c2:aneuploid:low.conf
TAATGAAAGACCCTTG-1	c2:aneuploid:low.conf
TAATGTCGGTTCATGG-1	c2:aneuploid:low.conf
TAATTACGTCAGTAGA-1	c1:diploid:low.conf
TAATTAGATGGATATG-1	c2:aneuploid:low.conf
TAATTAGGACATCCGT-1	c2:aneuploid:low.conf
TAATTGGAATCGGGAA-1	c2:aneuploid:low.conf
TACAACGCACAACTCA-1	c2:aneuploid:low.conf
TACAAGCTGTTCACTG-1	c2:aneuploid:low.conf
TACAAGGGCTTCTTTA-1	c2:aneuploid:low.conf
TACAATGAAACCAGCA-1	c2:aneuploid:low.conf
TACACAGCCGTGGTGC-1	c2:aneuploid:low.conf
TACACCGTCGTTAGTC-1	c2:aneuploid:low.conf
TACACCTCTTCGAATC-1	c2:aneuploid:low.conf
TACAGAAACGGTGGGC-1	c2:aneuploid:low.conf
TACATAGGCATACACC-1	c2:aneuploid:low.conf
TACATTTCTAACGTGC-1	c2:aneuploid:low.conf
TACCAAATAGCCCAGA-1	c2:aneuploid:low.conf
TACCAATAAAGTACCA-1	c2:aneuploid:low.conf
TACCAGAAGTAGGTTC-1	c2:aneuploid:low.conf
TACCAGCTAGGTTTAA-1	c2:aneuploid:low.conf
TACCAGGAATCCCGTC-1	c2:aneuploid:low.conf
TACCATGTATTGATTT-1	c2:aneuploid:low.conf
TACCGAATAATTGTAA-1	c2:aneuploid:low.conf
TACCGCGGACTTGCAG-1	c2:aneuploid:low.conf
TACCGGCTCACTGCCC-1	c2:aneuploid:low.conf
TACCGTAGGTTAACTA-1	c2:aneuploid:low.conf
TACCGTGCCTCGGACC-1	c2:aneuploid:low.conf
TACCTACTCCCAGTAT-1	c2:aneuploid:low.conf
TACCTCACGCTTGTAC-1	c2:aneuploid:low.conf
TACCTCAGTTGTCTGT-1	c2:aneuploid:low.conf
TACCTCCACACCAATG-1	c1:diploid:low.conf
TACCTGCTGCACTGTG-1	c2:aneuploid:low.conf
TACGAACACGACTTCA-1	c2:aneuploid:low.conf
TACGACGCTTGCTGCG-1	c2:aneuploid:low.conf
TACGACTGCCTCTTAG-1	c1:diploid:low.conf
TACGAGAACTTCACGT-1	c2:aneuploid:low.conf
TACGATGTTGATCATC-1	c2:aneuploid:low.conf
TACGCAGTTCTTTCCT-1	c2:aneuploid:low.conf
TACGCCATATTCTAAT-1	c2:aneuploid:low.conf
TACGCCGAGGGTACCC-1	c2:aneuploid:low.conf
TACGCCGCCTCAGAAG-1	c2:aneuploid:low.conf
TACGCCTCCATTCCGA-1	c2:aneuploid:low.conf
TACGCTATAGAAACCT-1	c2:aneuploid:low.conf
TACGCTCCTAGAACTG-1	c2:aneuploid:low.conf
TACGCTGCTGTGTTAA-1	c1:diploid:low.conf
TACGGAAGCCAAACCA-1	c2:aneuploid:low.conf
TACGGGATGCTAGCAG-1	c2:aneuploid:low.conf
TACGTAAAGCGGAGTG-1	c1:diploid:low.conf
TACGTACTAGTGCTGA-1	c1:diploid:low.conf
TACGTGCAAGGTTCCT-1	c2:aneuploid:low.conf
TACGTGCACTATGCTG-1	c2:aneuploid:low.conf
TACGTGGGCCCAGGGC-1	c2:aneuploid:low.conf
TACTACGTGCAATGCG-1	c2:aneuploid:low.conf
TACTATGGTTCCTCAG-1	c2:aneuploid:low.conf
TACTCCTCTAGTTGAC-1	c1:diploid:low.conf
TACTCTCCGAACAAAT-1	c2:aneuploid:low.conf
TACTCTTACTTTACTG-1	c2:aneuploid:low.conf
TACTCTTTCGTCTTCA-1	c2:aneuploid:low.conf
TACTGAACAGATTTAG-1	c1:diploid:low.conf
TACTGCAATCAATTAC-1	c2:aneuploid:low.conf
TACTGCATGATTAAAT-1	c2:aneuploid:low.conf
TACTGTTTCTCTGGTA-1	c2:aneuploid:low.conf
TACTTAAACATGTACA-1	c1:diploid:low.conf
TACTTGTTAGTAGTCC-1	c2:aneuploid:low.conf
TACTTTACTGAGCCGG-1	c2:aneuploid:low.conf
TAGAAACCACTAAGTA-1	c2:aneuploid:low.conf
TAGAAAGGTGGCGCTA-1	c2:aneuploid:low.conf
TAGAATAGCCGATGAA-1	c1:diploid:low.conf
TAGAATTAAGGGCAAC-1	c2:aneuploid:low.conf
TAGACGAAACGCCAAT-1	c2:aneuploid:low.conf
TAGACGCCCGTACCGG-1	c2:aneuploid:low.conf
TAGACTACCTAGCGTT-1	c2:aneuploid:low.conf
TAGAGCTACGAAGAAC-1	c2:aneuploid:low.conf
TAGAGGGAGTTTATCT-1	c2:aneuploid:low.conf
TAGAGGTTCTACTTGT-1	c2:aneuploid:low.conf
TAGAGTCTAAGCGAAC-1	c2:aneuploid:low.conf
TAGATATGGACTGGAA-1	c2:aneuploid:low.conf
TAGATCCGAAGTCGCA-1	c2:aneuploid:low.conf
TAGATGGTTCCTTACT-1	c2:aneuploid:low.conf
TAGATTCAAAGTGCGG-1	c2:aneuploid:low.conf
TAGCAACCTGTCACAA-1	c2:aneuploid:low.conf
TAGCAGTAAATACGCG-1	c2:aneuploid:low.conf
TAGCAGTATGACTAAA-1	c1:diploid:low.conf
TAGCCATTTCAAAGTC-1	c2:aneuploid:low.conf
TAGCCGGCGGTCAGCG-1	c2:aneuploid:low.conf
TAGCGTCCCTCGATTG-1	c2:aneuploid:low.conf
TAGCGTCCGGTGTGGT-1	c2:aneuploid:low.conf
TAGCGTTGGGTCTTAC-1	c2:aneuploid:low.conf
TAGCTAAGTCCGGGAG-1	c2:aneuploid:low.conf
TAGCTAGAAGGCATGA-1	c2:aneuploid:low.conf
TAGCTAGTGATGATGG-1	c2:aneuploid:low.conf
TAGCTCAGATCCTAGT-1	c2:aneuploid:low.conf
TAGCTCGCCTGATAAC-1	c1:diploid:low.conf
TAGGAACAGCCTCCAG-1	c2:aneuploid:low.conf
TAGGATCTTAACCGCA-1	c1:diploid:low.conf
TAGGCATGTTACGCCA-1	c2:aneuploid:low.conf
TAGGCTAAAGTGGCAC-1	c1:diploid:low.conf
TAGGGAGCTTGGGATG-1	c2:aneuploid:low.conf
TAGGGTGTTTCAAGAG-1	c2:aneuploid:low.conf
TAGGTCGCCGGAACTG-1	c2:aneuploid:low.conf
TAGGTGACGATAACCT-1	c2:aneuploid:low.conf
TAGGTGAGCCCTACTC-1	c2:aneuploid:low.conf
TAGGTGCTCGCCTAGC-1	c2:aneuploid:low.conf
TAGGTGTTCCACAGAT-1	c2:aneuploid:low.conf
TAGGTTCGAGTTCGTC-1	c2:aneuploid:low.conf
TAGGTTCTGCTGAGAA-1	c2:aneuploid:low.conf
TAGTACCTTAGTGGTC-1	c2:aneuploid:low.conf
TAGTAGCTTATACCAG-1	c1:diploid:low.conf
TAGTAGTTGCCGGACA-1	c2:aneuploid:low.conf
TAGTCCCGGAGACCAC-1	c2:aneuploid:low.conf
TAGTCCGCAGAGAATG-1	c2:aneuploid:low.conf
TAGTCCGTATGCATAA-1	c2:aneuploid:low.conf
TAGTCCTGCACTAAGC-1	c2:aneuploid:low.conf
TAGTCGATCACGGGTT-1	c2:aneuploid:low.conf
TAGTCTAACAACGAGA-1	c1:diploid:low.conf
TAGTCTGCGGCACATT-1	c1:diploid:low.conf
TAGTCTGTGACGTTGC-1	c2:aneuploid:low.conf
TAGTCTTTCCGAATTG-1	c2:aneuploid:low.conf
TAGTGAGAAGTGGTTG-1	c2:aneuploid:low.conf
TAGTGCCCTCCAGAGT-1	c2:aneuploid:low.conf
TAGTGGAACTCATACA-1	c2:aneuploid:low.conf
TAGTGTCAGAAACGGC-1	c2:aneuploid:low.conf
TAGTTAAGATAGGATA-1	c2:aneuploid:low.conf
TAGTTTATTCTTGCTT-1	c2:aneuploid:low.conf
TATAAGTGAGGATAGC-1	c2:aneuploid:low.conf
TATACACAGACGCCTT-1	c1:diploid:low.conf
TATACACGCAAAGTAT-1	c2:aneuploid:low.conf
TATACCGAGTGCCACA-1	c1:diploid:low.conf
TATACGCGTCATCACT-1	c2:aneuploid:low.conf
TATACTCATGCGGCAA-1	c2:aneuploid:low.conf
TATAGAGTCGCTTGAA-1	c1:diploid:low.conf
TATAGATGGTCGCAGT-1	c2:aneuploid:low.conf
TATATAGGGCTTTACG-1	c1:diploid:low.conf
TATATATCGAGAAATG-1	c2:aneuploid:low.conf
TATATCAAAGTGATCT-1	c2:aneuploid:low.conf
TATATCCCTGGGAGGA-1	c2:aneuploid:low.conf
TATATTACAAATGTCG-1	c2:aneuploid:low.conf
TATATTCGCGTCGATA-1	c2:aneuploid:low.conf
TATCACAGCACGGGCA-1	c2:aneuploid:low.conf
TATCACCATGTAAAGT-1	c2:aneuploid:low.conf
TATCACCCAACCGACC-1	c2:aneuploid:low.conf
TATCACTTCGAGTAAC-1	c1:diploid:low.conf
TATCCAATTGGTTATC-1	c2:aneuploid:low.conf
TATCCATATCATGCGA-1	c2:aneuploid:low.conf
TATCCGCACCGTCGGG-1	c2:aneuploid:low.conf
TATCCTATCAACTGGT-1	c2:aneuploid:low.conf
TATCCTGCATGGGAAT-1	c2:aneuploid:low.conf
TATCGATCTATGCATA-1	c2:aneuploid:low.conf
TATCGATGATTAAACG-1	c2:aneuploid:low.conf
TATCTACCACAGCGGG-1	c2:aneuploid:low.conf
TATGAAGAATTAAGGT-1	c1:diploid:low.conf
TATGATAAATCTAACG-1	c2:aneuploid:low.conf
TATGATCCGGCACGCC-1	c2:aneuploid:low.conf
TATGATCTTCTCTTTA-1	c2:aneuploid:low.conf
TATGCTCCCTACTTAC-1	c2:aneuploid:low.conf
TATGGATGTGCTACGC-1	c2:aneuploid:low.conf
TATGGCCCGGCCTCGC-1	c2:aneuploid:low.conf
TATGGCTAGGCTAATT-1	c2:aneuploid:low.conf
TATGGGACCGAGCAGG-1	c2:aneuploid:low.conf
TATGGGTACGTATCGT-1	c2:aneuploid:low.conf
TATGGTCTGAGTAACA-1	c2:aneuploid:low.conf
TATGGTTAGTGGGAGA-1	c2:aneuploid:low.conf
TATGTAAAGTGCTTAA-1	c2:aneuploid:low.conf
TATGTCAAGACCGACT-1	c2:aneuploid:low.conf
TATGTCTCATTGTGCC-1	c2:aneuploid:low.conf
TATTAACCTGACCGCG-1	c1:diploid:low.conf
TATTACCATCCTGCTT-1	c2:aneuploid:low.conf
TATTCAATTCTAATCC-1	c2:aneuploid:low.conf
TATTCCACTCAGCTCG-1	c2:aneuploid:low.conf
TATTCCGAGCTGTTAT-1	c2:aneuploid:low.conf
TATTCCGGCAGTCCTA-1	c2:aneuploid:low.conf
TATTCCTCCGCCCACT-1	c1:diploid:low.conf
TATTCGTGCCAGAATA-1	c2:aneuploid:low.conf
TATTGACATTTCTGCC-1	c1:diploid:low.conf
TATTGCCGGGCTTGTA-1	c1:diploid:low.conf
TATTTAGTCTAGATCG-1	c2:aneuploid:low.conf
TATTTATACCGAGTAG-1	c2:aneuploid:low.conf
TATTTGATTTGCACAG-1	c2:aneuploid:low.conf
TCAAACAACCGCGTCG-1	c2:aneuploid:low.conf
TCAAACTTAGATTGTT-1	c2:aneuploid:low.conf
TCAAAGTCACGGCGTC-1	c2:aneuploid:low.conf
TCAAATTGTTGTGCCG-1	c2:aneuploid:low.conf
TCAAATTTGAGACTCA-1	c2:aneuploid:low.conf
TCAACAAAGATAATTC-1	c2:aneuploid:low.conf
TCAACACATTGGGTAA-1	c2:aneuploid:low.conf
TCAACATAGCGCCCTA-1	c1:diploid:low.conf
TCAACCATGTTCGGGC-1	c2:aneuploid:low.conf
TCAACGAGGAGACAAA-1	c2:aneuploid:low.conf
TCAACGCAGGAAATAA-1	c2:aneuploid:low.conf
TCAACTGCAGAGTCAG-1	c2:aneuploid:low.conf
TCAAGAAATACTAGCT-1	c1:diploid:low.conf
TCAAGCGCGGACGGTA-1	c2:aneuploid:low.conf
TCAAGCTGCCTTGAAA-1	c2:aneuploid:low.conf
TCAAGGTTACTACACC-1	c2:aneuploid:low.conf
TCAATACGCCGTCATG-1	c2:aneuploid:low.conf
TCACAAACCGAGGTAC-1	c2:aneuploid:low.conf
TCACAGATCCTCAAAC-1	c2:aneuploid:low.conf
TCACAGCAAACTCGAA-1	c2:aneuploid:low.conf
TCACAGGAGAATAAGA-1	c2:aneuploid:low.conf
TCACAGGGAATCGCAA-1	c2:aneuploid:low.conf
TCACAGGTTATTGGGC-1	c2:aneuploid:low.conf
TCACATCTTATCTGAT-1	c2:aneuploid:low.conf
TCACCCTCTTAAGATT-1	c2:aneuploid:low.conf
TCACCGCTCGGCACTC-1	c2:aneuploid:low.conf
TCACGATGTCCGTGGA-1	c2:aneuploid:low.conf
TCACGCATTGTAGATC-1	c1:diploid:low.conf
TCACGGCCCAAGAGAG-1	c2:aneuploid:low.conf
TCACGTGCCCGATTCA-1	c2:aneuploid:low.conf
TCACTACGACCAATGC-1	c2:aneuploid:low.conf
TCACTCAGCGCATTAG-1	c2:aneuploid:low.conf
TCACTCGTGCAACGGC-1	c2:aneuploid:low.conf
TCAGAACCTCCACAGG-1	c1:diploid:low.conf
TCAGACGCTATAGAAG-1	c2:aneuploid:low.conf
TCAGATGGAGACGTAG-1	c2:aneuploid:low.conf
TCAGCAAATGCATCTC-1	c2:aneuploid:low.conf
TCAGCAGTAGGCCCTG-1	c1:diploid:low.conf
TCAGCCAATCCGTAAA-1	c1:diploid:low.conf
TCAGCGCACGCCGTTT-1	c2:aneuploid:low.conf
TCAGGGCGCAAACTCG-1	c2:aneuploid:low.conf
TCAGGGTGCACGAAAC-1	c2:aneuploid:low.conf
TCAGGGTGTAACGTAA-1	c2:aneuploid:low.conf
TCAGGTTCTTTGAGAA-1	c2:aneuploid:low.conf
TCAGTACTGACCCGCG-1	c2:aneuploid:low.conf
TCAGTAGGGACTATAA-1	c2:aneuploid:low.conf
TCAGTGTATACGTCAT-1	c2:aneuploid:low.conf
TCAGTTACGGAATGAT-1	c2:aneuploid:low.conf
TCATACTTACAGATCC-1	c2:aneuploid:low.conf
TCATATGAGCTTTGTT-1	c2:aneuploid:low.conf
TCATCACTCGAGCTCG-1	c2:aneuploid:low.conf
TCATCCCAGAGGGTGG-1	c2:aneuploid:low.conf
TCATCCTCAGCTGCTT-1	c2:aneuploid:low.conf
TCATCGACGACCGTCG-1	c2:aneuploid:low.conf
TCATCGATGGTCCCAA-1	c2:aneuploid:low.conf
TCATGCAGGTTCTCAT-1	c2:aneuploid:low.conf
TCATTCGTATAATTTG-1	c2:aneuploid:low.conf
TCATTTAAGTCTCCGA-1	c2:aneuploid:low.conf
TCATTTAGAAGTGTGA-1	c2:aneuploid:low.conf
TCCAACTCAGCTATCT-1	c2:aneuploid:low.conf
TCCAACTTTAAATTCT-1	c2:aneuploid:low.conf
TCCAAGCCTAGACACA-1	c2:aneuploid:low.conf
TCCAATAAAGGCTACC-1	c2:aneuploid:low.conf
TCCACAATGGTTTACG-1	c2:aneuploid:low.conf
TCCACATCGTATATTG-1	c2:aneuploid:low.conf
TCCACCTCTAGCCTTT-1	c2:aneuploid:low.conf
TCCACTTTATCTAGGT-1	c2:aneuploid:low.conf
TCCAGAGCACCGGTTC-1	c2:aneuploid:low.conf
TCCAGATGTACGCCAA-1	c2:aneuploid:low.conf
TCCAGCGCTATAAGCG-1	c2:aneuploid:low.conf
TCCAGGCAGGACGATC-1	c1:diploid:low.conf
TCCAGGCGAGTACGGT-1	c2:aneuploid:low.conf
TCCAGGGTATATACGA-1	c2:aneuploid:low.conf
TCCATTAGTTGGATAG-1	c2:aneuploid:low.conf
TCCATTCCCACTAGAG-1	c2:aneuploid:low.conf
TCCATTGTGACCTCGT-1	c2:aneuploid:low.conf
TCCCAAACAGACAACG-1	c2:aneuploid:low.conf
TCCCAAACATCCTCTA-1	c2:aneuploid:low.conf
TCCCAAAGACGAAGGA-1	c2:aneuploid:low.conf
TCCCAAAGCCCTAAAT-1	c2:aneuploid:low.conf
TCCCACTCTCTTCCGG-1	c1:diploid:low.conf
TCCCAGCTTTAGTCTG-1	c2:aneuploid:low.conf
TCCCAGGCTTAGCTAA-1	c2:aneuploid:low.conf
TCCCGCCTATGTGCGT-1	c2:aneuploid:low.conf
TCCCGCGTACTCCTGG-1	c2:aneuploid:low.conf
TCCCGGGTGTGCTGCT-1	c2:aneuploid:low.conf
TCCCGGTCAGGAATTT-1	c2:aneuploid:low.conf
TCCCGTCAGTCCCGCA-1	c2:aneuploid:low.conf
TCCCGTCGCGTCATAG-1	c2:aneuploid:low.conf
TCCCGTGTGCAATTTG-1	c2:aneuploid:low.conf
TCCCTAGATCAATAGG-1	c2:aneuploid:low.conf
TCCCTTAGATTACTCG-1	c2:aneuploid:low.conf
TCCCTTGTCTGAAACT-1	c1:diploid:low.conf
TCCGAACGTTGCCGCT-1	c2:aneuploid:low.conf
TCCGAAGTAGTCACCA-1	c2:aneuploid:low.conf
TCCGAATGGTCCTGAG-1	c2:aneuploid:low.conf
TCCGACCGCTAATCAA-1	c2:aneuploid:low.conf
TCCGAGAAGGCTAAGC-1	c2:aneuploid:low.conf
TCCGATAATTGCCATA-1	c2:aneuploid:low.conf
TCCGATGACTGAGCTC-1	c2:aneuploid:low.conf
TCCGATGGTGCGACAT-1	c2:aneuploid:low.conf
TCCGATTACATTGCCG-1	c2:aneuploid:low.conf
TCCGCCTGTCTACAAG-1	c2:aneuploid:low.conf
TCCGCGGCAGCATCTG-1	c2:aneuploid:low.conf
TCCGCGGCCCAATGAA-1	c2:aneuploid:low.conf
TCCGCTGTCATCCCGG-1	c2:aneuploid:low.conf
TCCGCTTATCCCATTA-1	c2:aneuploid:low.conf
TCCGGAGGAAGGGCTG-1	c2:aneuploid:low.conf
TCCGGCCTAGCGTACA-1	c2:aneuploid:low.conf
TCCGGGCTTGACGGGA-1	c1:diploid:low.conf
TCCGGTTCGTCCGGTC-1	c2:aneuploid:low.conf
TCCGTAACCACAATCC-1	c2:aneuploid:low.conf
TCCGTTAAGCTAATAT-1	c2:aneuploid:low.conf
TCCGTTTAGCCTTGAA-1	c2:aneuploid:low.conf
TCCTAAAGATTCAGAC-1	c2:aneuploid:low.conf
TCCTAAATTGGGAAGC-1	c2:aneuploid:low.conf
TCCTAACCGTCGGGCA-1	c2:aneuploid:low.conf
TCCTACATCCACGGCC-1	c2:aneuploid:low.conf
TCCTAGCAAAGAAGCT-1	c1:diploid:low.conf
TCCTATCATAGGTAAC-1	c2:aneuploid:low.conf
TCCTCGGGCTGGGCTT-1	c2:aneuploid:low.conf
TCCTCTACGAGATGGC-1	c2:aneuploid:low.conf
TCCTCTGGCCCATTAG-1	c2:aneuploid:low.conf
TCCTGCAGCCGCCAAT-1	c2:aneuploid:low.conf
TCCTGCCAACTGGAGA-1	c2:aneuploid:low.conf
TCCTGGCGCTGCCTGG-1	c2:aneuploid:low.conf
TCCTTACGACGGTCCG-1	c2:aneuploid:low.conf
TCCTTCAGTGGTCGAA-1	c2:aneuploid:low.conf
TCCTTGTCCTTTAATT-1	c2:aneuploid:low.conf
TCCTTTAAATCCGCTT-1	c2:aneuploid:low.conf
TCCTTTCTTACGCTTA-1	c1:diploid:low.conf
TCGAAATTTAGGACCA-1	c2:aneuploid:low.conf
TCGAAGAACCGAGCAC-1	c2:aneuploid:low.conf
TCGAATATCCCGCAGG-1	c2:aneuploid:low.conf
TCGAATCGCAGGGTAG-1	c2:aneuploid:low.conf
TCGACATAGCGTAGCG-1	c2:aneuploid:low.conf
TCGAGACCAACACCGT-1	c2:aneuploid:low.conf
TCGAGCCAGGCAGGCC-1	c2:aneuploid:low.conf
TCGATAGGCTAGTCGC-1	c2:aneuploid:low.conf
TCGATTTACGAAACGA-1	c1:diploid:low.conf
TCGCAAAGATGCATTT-1	c2:aneuploid:low.conf
TCGCACCAGGAGGCAG-1	c2:aneuploid:low.conf
TCGCATCCCTAAGTGT-1	c2:aneuploid:low.conf
TCGCATTCAATGACTT-1	c2:aneuploid:low.conf
TCGCCACCCGGATTAC-1	c1:diploid:low.conf
TCGCCCAACTGACTCC-1	c2:aneuploid:low.conf
TCGCCGAAGTTGCGTC-1	c2:aneuploid:low.conf
TCGCCGACATATTCGC-1	c2:aneuploid:low.conf
TCGCCGGTCGATCCGT-1	c2:aneuploid:low.conf
TCGCGTCCAGAAGGTC-1	c2:aneuploid:low.conf
TCGCTAAACCGCTATC-1	c2:aneuploid:low.conf
TCGCTACTGGCTTTGA-1	c2:aneuploid:low.conf
TCGCTCGATATATTCC-1	c2:aneuploid:low.conf
TCGCTCGGCACCAGCG-1	c2:aneuploid:low.conf
TCGCTGCCAATGCTGT-1	c2:aneuploid:low.conf
TCGCTGGGCGGATTGT-1	c2:aneuploid:low.conf
TCGCTGTGCGTAAATC-1	c2:aneuploid:low.conf
TCGCTTAATTACGAAG-1	c2:aneuploid:low.conf
TCGCTTTAAACGTTTG-1	c2:aneuploid:low.conf
TCGGAATGACCATCAA-1	c2:aneuploid:low.conf
TCGGAATGCGCTCTGA-1	c2:aneuploid:low.conf
TCGGACGCCCAGCCCA-1	c2:aneuploid:low.conf
TCGGAGTACATGAGTA-1	c2:aneuploid:low.conf
TCGGCGAACCCAAACC-1	c2:aneuploid:low.conf
TCGGCTAACTTCCCTT-1	c2:aneuploid:low.conf
TCGGCTTGTATCGACG-1	c2:aneuploid:low.conf
TCGGGAACGTGCCTAG-1	c2:aneuploid:low.conf
TCGGGAGACAGCGTAC-1	c2:aneuploid:low.conf
TCGGGCACTTCTGGAT-1	c2:aneuploid:low.conf
TCGGGCCGTCGTGGTA-1	c2:aneuploid:low.conf
TCGGGTGAAACTGCTA-1	c2:aneuploid:low.conf
TCGGTCCCTGACTCCA-1	c2:aneuploid:low.conf
TCGGTGACCGCTCCGG-1	c2:aneuploid:low.conf
TCGGTTAGCCATGTAG-1	c2:aneuploid:low.conf
TCGTAAGACGACATTG-1	c2:aneuploid:low.conf
TCGTAAGCTCCGAGGA-1	c2:aneuploid:low.conf
TCGTACCGACGTCAAG-1	c2:aneuploid:low.conf
TCGTATAGTGCAATTA-1	c2:aneuploid:low.conf
TCGTATTTCGTCCGGA-1	c2:aneuploid:low.conf
TCGTCAAGTACGCGCA-1	c2:aneuploid:low.conf
TCGTCACACTGTTAGC-1	c2:aneuploid:low.conf
TCGTCCGCTGGCGTCT-1	c2:aneuploid:low.conf
TCGTCCGGGTACACTC-1	c2:aneuploid:low.conf
TCGTCTTAGGCGTTAA-1	c2:aneuploid:low.conf
TCGTGTTCGACCACAA-1	c2:aneuploid:low.conf
TCGTTAGGAGTCCCTA-1	c2:aneuploid:low.conf
TCGTTCGTTATTATGT-1	c2:aneuploid:low.conf
TCGTTGCTATCCGGTC-1	c2:aneuploid:low.conf
TCGTTGGCTCGTCAAT-1	c2:aneuploid:low.conf
TCGTTTACGCGACCCT-1	c2:aneuploid:low.conf
TCTACACGTTCATGCA-1	c2:aneuploid:low.conf
TCTACCCAATAGAGAG-1	c2:aneuploid:low.conf
TCTACCGTCCACAAGC-1	c2:aneuploid:low.conf
TCTACGCACGATCTCC-1	c2:aneuploid:low.conf
TCTACGGGCTCAGTTG-1	c2:aneuploid:low.conf
TCTAGCATGCCCAGAA-1	c2:aneuploid:low.conf
TCTAGGTGGCGACGCT-1	c2:aneuploid:low.conf
TCTAGTGATATCGTGG-1	c2:aneuploid:low.conf
TCTAGTTATCAGAAGA-1	c2:aneuploid:low.conf
TCTATAGGTGGGTAAT-1	c2:aneuploid:low.conf
TCTATCATGCAGTTAC-1	c2:aneuploid:low.conf
TCTATCGGTCGCAACA-1	c2:aneuploid:low.conf
TCTATGCTATAACGAC-1	c1:diploid:low.conf
TCTATTACGCTGGCGA-1	c2:aneuploid:low.conf
TCTCATGAGATAGGGT-1	c2:aneuploid:low.conf
TCTCCAACGTAGGTTA-1	c2:aneuploid:low.conf
TCTCCACAAGTTGAAT-1	c1:diploid:low.conf
TCTCCCTGGGCAGCGT-1	c2:aneuploid:low.conf
TCTCGAACGAGGTCAC-1	c2:aneuploid:low.conf
TCTCGACGTATCGCCG-1	c2:aneuploid:low.conf
TCTCGAGGAGGTTCGC-1	c2:aneuploid:low.conf
TCTCGGCTCCAGGACT-1	c2:aneuploid:low.conf
TCTCTAATAGCTGGTA-1	c2:aneuploid:low.conf
TCTCTCGCCGCACATA-1	c2:aneuploid:low.conf
TCTCTTACCGCGAACC-1	c2:aneuploid:low.conf
TCTGAACCGGTCGGCT-1	c2:aneuploid:low.conf
TCTGAACTCGTACCCG-1	c2:aneuploid:low.conf
TCTGAAGCACGTGGTC-1	c2:aneuploid:low.conf
TCTGAATTCCGTACAA-1	c2:aneuploid:low.conf
TCTGACGGGCTAACCC-1	c2:aneuploid:low.conf
TCTGACTGTAATGGTT-1	c2:aneuploid:low.conf
TCTGAGCAATTGACTG-1	c2:aneuploid:low.conf
TCTGATCGGGTGCTAG-1	c1:diploid:low.conf
TCTGATGTATTCTGTC-1	c2:aneuploid:low.conf
TCTGATTGGAAATGGA-1	c2:aneuploid:low.conf
TCTGCACCATTAGTAA-1	c2:aneuploid:low.conf
TCTGCATACCTTGCTT-1	c2:aneuploid:low.conf
TCTGCCAGAAACTGCA-1	c2:aneuploid:low.conf
TCTGCGAATCGTTCGC-1	c2:aneuploid:low.conf
TCTGCGTCCGGTTTCT-1	c2:aneuploid:low.conf
TCTGCTTAGAACAAGC-1	c2:aneuploid:low.conf
TCTGGAGCGTAAGAGT-1	c2:aneuploid:low.conf
TCTGGCCGTTCAAGTT-1	c2:aneuploid:low.conf
TCTGGGAACCTTTGAA-1	c2:aneuploid:low.conf
TCTGGGTAGCGCTCAT-1	c1:diploid:low.conf
TCTGTCATACAAGAGC-1	c2:aneuploid:low.conf
TCTGTGATGGAGGTTG-1	c2:aneuploid:low.conf
TCTGTGCCATCATAGT-1	c2:aneuploid:low.conf
TCTGTGGCTACATTTC-1	c2:aneuploid:low.conf
TCTGTTACCCAGCATA-1	c2:aneuploid:low.conf
TCTTACAGAGGTACCG-1	c2:aneuploid:low.conf
TCTTACCGGAACTCGT-1	c2:aneuploid:low.conf
TCTTACGGCATCCGAC-1	c2:aneuploid:low.conf
TCTTACTTATGCCTCT-1	c2:aneuploid:low.conf
TCTTAGAGCTCCAATT-1	c2:aneuploid:low.conf
TCTTAGAGTGAACTCT-1	c2:aneuploid:low.conf
TCTTATGGGTAGTACC-1	c2:aneuploid:low.conf
TCTTCCCATGGGCACA-1	c2:aneuploid:low.conf
TCTTCGAATAGACGTT-1	c2:aneuploid:low.conf
TCTTCGATACCAATAA-1	c2:aneuploid:low.conf
TCTTCTATAACCCGCC-1	c2:aneuploid:low.conf
TCTTGATGCGTAGCGA-1	c2:aneuploid:low.conf
TCTTGCTCCCGATACT-1	c2:aneuploid:low.conf
TCTTGGTAACACCAAA-1	c2:aneuploid:low.conf
TCTTGGTCAATGATAC-1	c2:aneuploid:low.conf
TCTTTAAGACTATGAA-1	c2:aneuploid:low.conf
TCTTTAGAGTCTAACA-1	c2:aneuploid:low.conf
TCTTTAGCAGGCGAAC-1	c2:aneuploid:low.conf
TCTTTCTCTTAAGGAG-1	c2:aneuploid:low.conf
TGAAACTTATGCAAGC-1	c2:aneuploid:low.conf
TGAAAGGACCTGACTC-1	c1:diploid:low.conf
TGAACAAGCAGGGACT-1	c2:aneuploid:low.conf
TGAATACCGACGCGTA-1	c2:aneuploid:low.conf
TGAATATGCTATAAAC-1	c2:aneuploid:low.conf
TGAATGAGATACAGCA-1	c1:diploid:low.conf
TGAATGAGTGTTTCCC-1	c2:aneuploid:low.conf
TGAATGTCAGCCGGCC-1	c2:aneuploid:low.conf
TGACAACGCATGTCGC-1	c2:aneuploid:low.conf
TGACAACTTAAAGGTG-1	c2:aneuploid:low.conf
TGACACTTCTCTTTGC-1	c2:aneuploid:low.conf
TGACATCGAGCGGACC-1	c2:aneuploid:low.conf
TGACATGTAACGTGAC-1	c2:aneuploid:low.conf
TGACCAAATCTTAAAC-1	c2:aneuploid:low.conf
TGACCAGCTTCAAAGT-1	c2:aneuploid:low.conf
TGACCCAACTCACATT-1	c2:aneuploid:low.conf
TGACCCACGTTAGACA-1	c2:aneuploid:low.conf
TGACGATGCACTAGAA-1	c2:aneuploid:low.conf
TGACTATAATCCTTTC-1	c2:aneuploid:low.conf
TGAGAATGCTTTACCG-1	c2:aneuploid:low.conf
TGAGAGATTTACCACG-1	c2:aneuploid:low.conf
TGAGATCAAATACTCA-1	c2:aneuploid:low.conf
TGAGATTAGGCCCTAA-1	c1:diploid:low.conf
TGAGCAGTCGTGAAGT-1	c2:aneuploid:low.conf
TGAGCCATACAGTCTC-1	c2:aneuploid:low.conf
TGAGCGGAAAGTGTTC-1	c2:aneuploid:low.conf
TGAGCTTTAATGACGC-1	c2:aneuploid:low.conf
TGAGGAGTGCCAGCTT-1	c2:aneuploid:low.conf
TGAGGTGTGTGGCGGA-1	c2:aneuploid:low.conf
TGAGGTTGATCCCAAG-1	c2:aneuploid:low.conf
TGAGTAAATTAGCGTA-1	c2:aneuploid:low.conf
TGAGTGCCTCTTAAAT-1	c2:aneuploid:low.conf
TGAGTGGTCCGTGACG-1	c2:aneuploid:low.conf
TGAGTTAAAGACATTC-1	c2:aneuploid:low.conf
TGATACATTTAGCCGT-1	c1:diploid:low.conf
TGATCACCACACTGAC-1	c2:aneuploid:low.conf
TGATCCCAGCATTAGT-1	c1:diploid:low.conf
TGATCGGTTTGACCCT-1	c2:aneuploid:low.conf
TGATCTACGCTGATCT-1	c1:diploid:low.conf
TGATCTCCGGCGCCAG-1	c2:aneuploid:low.conf
TGATGCTCACGTAGTC-1	c2:aneuploid:low.conf
TGATGGCTGTTTCTGA-1	c2:aneuploid:low.conf
TGATGTCAATTAAGTG-1	c2:aneuploid:low.conf
TGATTATGGCACGCAG-1	c2:aneuploid:low.conf
TGATTCCCGGTTACCT-1	c2:aneuploid:low.conf
TGATTCGTCTATCACT-1	c2:aneuploid:low.conf
TGATTCTGTCGCCGGT-1	c2:aneuploid:low.conf
TGATTTCCTCCTGACG-1	c2:aneuploid:low.conf
TGCAAACGTACTAGTT-1	c2:aneuploid:low.conf
TGCAAAGTTCGTCTGT-1	c2:aneuploid:low.conf
TGCAACCCATCTGCGG-1	c2:aneuploid:low.conf
TGCAACTACTGGTTGA-1	c2:aneuploid:low.conf
TGCAAGAATGACGTAA-1	c1:diploid:low.conf
TGCAATCTAACACGGT-1	c2:aneuploid:low.conf
TGCAATTTGGGCACGG-1	c2:aneuploid:low.conf
TGCACAGTGAAGTTAT-1	c2:aneuploid:low.conf
TGCACGAGTCGGCAGC-1	c2:aneuploid:low.conf
TGCACTATGTGAGTGC-1	c2:aneuploid:low.conf
TGCAGAGTACCGAGCA-1	c1:diploid:low.conf
TGCAGGATCGGCAAAG-1	c1:diploid:low.conf
TGCAGTGAGGCTCGGG-1	c2:aneuploid:low.conf
TGCAGTGGTAGGGAAC-1	c1:diploid:low.conf
TGCAGTTTCCTCCCAT-1	c2:aneuploid:low.conf
TGCATATGTCTGTCAC-1	c2:aneuploid:low.conf
TGCATCTCCGGATCTT-1	c2:aneuploid:low.conf
TGCATGGATCGGATCT-1	c2:aneuploid:low.conf
TGCATGTGACCCATAG-1	c2:aneuploid:low.conf
TGCATGTGGTAATCTA-1	c2:aneuploid:low.conf
TGCCAATGGGTACTCT-1	c2:aneuploid:low.conf
TGCCACCTGGCGAAAC-1	c2:aneuploid:low.conf
TGCCAGTACGTGGAGA-1	c2:aneuploid:low.conf
TGCCATTACTAAAGAA-1	c2:aneuploid:low.conf
TGCCCGATAGTTAGAA-1	c2:aneuploid:low.conf
TGCCCGTACCGTTAAA-1	c2:aneuploid:low.conf
TGCCGAAAGCGTATTC-1	c1:diploid:low.conf
TGCCGGATGTACGAGC-1	c1:diploid:low.conf
TGCCGTGGATCGTCCT-1	c2:aneuploid:low.conf
TGCCGTGGGACCCAAT-1	c2:aneuploid:low.conf
TGCCTAAATTTAATAG-1	c2:aneuploid:low.conf
TGCCTAATTGAAGATT-1	c2:aneuploid:low.conf
TGCCTGACATCGGTCA-1	c2:aneuploid:low.conf
TGCCTGATCAAACGAT-1	c2:aneuploid:low.conf
TGCCTTGGCCAGGCAA-1	c2:aneuploid:low.conf
TGCGACACCCTAGTGC-1	c2:aneuploid:low.conf
TGCGACGGCCGAACGT-1	c2:aneuploid:low.conf
TGCGAGAATATTACCC-1	c1:diploid:low.conf
TGCGAGATGGCGGCCA-1	c2:aneuploid:low.conf
TGCGAGCCCTTCCGCG-1	c2:aneuploid:low.conf
TGCGCAAAGCATTTGG-1	c2:aneuploid:low.conf
TGCGCCGTTAATAACG-1	c2:aneuploid:low.conf
TGCGCGATTAACGGAG-1	c2:aneuploid:low.conf
TGCGGACTTGACTCCG-1	c2:aneuploid:low.conf
TGCGGAGTAAAGGTGC-1	c2:aneuploid:low.conf
TGCGGCATAGTTCAAC-1	c2:aneuploid:low.conf
TGCGGGTATTGGGATC-1	c2:aneuploid:low.conf
TGCGGTGAAATTTCAT-1	c2:aneuploid:low.conf
TGCGTAAGAACCTGAT-1	c2:aneuploid:low.conf
TGCGTACGGCTAATTG-1	c1:diploid:low.conf
TGCGTGATTGGGTGTC-1	c2:aneuploid:low.conf
TGCGTTTGTTGACACT-1	c2:aneuploid:low.conf
TGCTAAGTGTCTATTT-1	c2:aneuploid:low.conf
TGCTATACAAACGGAC-1	c2:aneuploid:low.conf
TGCTATGGCAAAGGGA-1	c2:aneuploid:low.conf
TGCTCAAAGGATGCAC-1	c1:diploid:low.conf
TGCTCCACAGTTCTTA-1	c2:aneuploid:low.conf
TGCTCGGCGAAACCCA-1	c2:aneuploid:low.conf
TGCTCGGTGGGTCACC-1	c2:aneuploid:low.conf
TGCTCTGCCGGTTCAC-1	c2:aneuploid:low.conf
TGCTCTTGAGAGTTTG-1	c2:aneuploid:low.conf
TGCTGCGTCAGAGTTA-1	c2:aneuploid:low.conf
TGCTGGTTGGACAATT-1	c2:aneuploid:low.conf
TGCTGTTGAAGAACTC-1	c2:aneuploid:low.conf
TGCTTCCCAAGCAGTA-1	c2:aneuploid:low.conf
TGCTTGAAACCATGCA-1	c2:aneuploid:low.conf
TGGAAACGGAGTGAAC-1	c2:aneuploid:low.conf
TGGAACCACTGACACA-1	c1:diploid:low.conf
TGGAAGAAGGGAACGT-1	c1:diploid:low.conf
TGGAAGACGAACACCA-1	c2:aneuploid:low.conf
TGGAAGGATAAAGATG-1	c2:aneuploid:low.conf
TGGAATATCCTTGACC-1	c2:aneuploid:low.conf
TGGAATTAGACGCTTT-1	c2:aneuploid:low.conf
TGGACCAATCTAAGAT-1	c2:aneuploid:low.conf
TGGACCACGGCGTTGA-1	c2:aneuploid:low.conf
TGGACTGTTCGCTCAA-1	c2:aneuploid:low.conf
TGGAGAATAATCGTCC-1	c2:aneuploid:low.conf
TGGAGCTAAAGTTCCC-1	c2:aneuploid:low.conf
TGGAGGGAAACACCTC-1	c2:aneuploid:low.conf
TGGAGTGATGCGATGA-1	c2:aneuploid:low.conf
TGGATGGCATCTTGGA-1	c2:aneuploid:low.conf
TGGCAAACTAAATTAC-1	c2:aneuploid:low.conf
TGGCAACTCGCGCGCC-1	c2:aneuploid:low.conf
TGGCAAGCACAAGTCG-1	c2:aneuploid:low.conf
TGGCAATGGGACGGCG-1	c2:aneuploid:low.conf
TGGCACGAGCTCGAGT-1	c2:aneuploid:low.conf
TGGCAGATTACGATCA-1	c2:aneuploid:low.conf
TGGCAGCAGTAATAGT-1	c2:aneuploid:low.conf
TGGCCAAACTGAAGTA-1	c2:aneuploid:low.conf
TGGCCGTATATTGACC-1	c2:aneuploid:low.conf
TGGCGACTGCTCCAAA-1	c2:aneuploid:low.conf
TGGCGATCAAGTTATG-1	c2:aneuploid:low.conf
TGGCGGTGTGCGATTG-1	c2:aneuploid:low.conf
TGGCTACACTCTACCT-1	c1:diploid:low.conf
TGGCTATGTGACATAC-1	c2:aneuploid:low.conf
TGGCTTGTACAAGCTT-1	c2:aneuploid:low.conf
TGGCTTTGGGTAGACA-1	c2:aneuploid:low.conf
TGGGAAATGCCTTTCC-1	c2:aneuploid:low.conf
TGGGATGCACTCATTC-1	c2:aneuploid:low.conf
TGGGCAATAGTTGGGT-1	c2:aneuploid:low.conf
TGGGCACAAACAGAAC-1	c2:aneuploid:low.conf
TGGGCACGTTCTATGG-1	c2:aneuploid:low.conf
TGGGCAGGCCACCGCA-1	c2:aneuploid:low.conf
TGGGCCACAAGAGCGC-1	c2:aneuploid:low.conf
TGGGCCCATACTAATT-1	c2:aneuploid:low.conf
TGGGCGATACAATAAG-1	c2:aneuploid:low.conf
TGGGTAAGGTTCCCGC-1	c2:aneuploid:low.conf
TGGGTGCACAAGCCAT-1	c2:aneuploid:low.conf
TGGGTGGGATGTCATT-1	c2:aneuploid:low.conf
TGGGTGTAATAGATTT-1	c1:diploid:low.conf
TGGGTGTTAAGTAGAA-1	c2:aneuploid:low.conf
TGGGTTTCGGGCGTAC-1	c2:aneuploid:low.conf
TGGTAGAATATATGGG-1	c2:aneuploid:low.conf
TGGTATCGCATCCCAA-1	c2:aneuploid:low.conf
TGGTATCGGTCTGTAT-1	c2:aneuploid:low.conf
TGGTCCCACGCTACGG-1	c2:aneuploid:low.conf
TGGTCGATATACCTCT-1	c1:diploid:low.conf
TGGTGATCGTATTTGT-1	c2:aneuploid:low.conf
TGGTGCCCTGCCTTAC-1	c2:aneuploid:low.conf
TGGTTAAGGGCGCTGG-1	c2:aneuploid:low.conf
TGGTTCAACGGGTAAT-1	c2:aneuploid:low.conf
TGGTTCGTAGCAAAGG-1	c2:aneuploid:low.conf
TGGTTGGAGGATCCTG-1	c2:aneuploid:low.conf
TGGTTTAAACGTGGGT-1	c2:aneuploid:low.conf
TGTACCTACACGAGGG-1	c2:aneuploid:low.conf
TGTACGAACAAATCCG-1	c1:diploid:low.conf
TGTACTACTCTCACGG-1	c2:aneuploid:low.conf
TGTACTGTGCCAAAGT-1	c2:aneuploid:low.conf
TGTACTTCCGGGCATG-1	c1:diploid:low.conf
TGTAGCCAATTCCGTT-1	c2:aneuploid:low.conf
TGTAGGAGAAATTTCC-1	c2:aneuploid:low.conf
TGTAGTGATCTATAAT-1	c2:aneuploid:low.conf
TGTATAACAGATCCTG-1	c2:aneuploid:low.conf
TGTATACGGATGATGA-1	c2:aneuploid:low.conf
TGTATCAGACTGAAGC-1	c2:aneuploid:low.conf
TGTATCCTTATTCCAT-1	c2:aneuploid:low.conf
TGTATGGCGCAGACAG-1	c2:aneuploid:low.conf
TGTATTTACCTAATGC-1	c2:aneuploid:low.conf
TGTCATTTGTTGGGAA-1	c2:aneuploid:low.conf
TGTCCACGGCTCAACT-1	c1:diploid:low.conf
TGTCCCGACATAGCAC-1	c2:aneuploid:low.conf
TGTCCGCAAACAATTC-1	c2:aneuploid:low.conf
TGTCCTAAGTCACCGC-1	c2:aneuploid:low.conf
TGTCGTGGGTATAGGC-1	c2:aneuploid:low.conf
TGTCTACAGTTTCTGT-1	c2:aneuploid:low.conf
TGTGACTACGCCAGTC-1	c2:aneuploid:low.conf
TGTGACTAGAGTTTGC-1	c1:diploid:low.conf
TGTGAGACTAGCCCAA-1	c2:aneuploid:low.conf
TGTGCCGGTGCCGGAA-1	c2:aneuploid:low.conf
TGTGGACTATCTACGT-1	c2:aneuploid:low.conf
TGTGGAGGAAGCTTAA-1	c2:aneuploid:low.conf
TGTGGCAAAGCGTATG-1	c2:aneuploid:low.conf
TGTGGCGGGCTTCTGG-1	c2:aneuploid:low.conf
TGTGGCTCCCACCAAC-1	c2:aneuploid:low.conf
TGTGGTTGCTAAAGCT-1	c2:aneuploid:low.conf
TGTGTCGCGAGTTGCA-1	c2:aneuploid:low.conf
TGTTATTGTATGTGGC-1	c2:aneuploid:low.conf
TGTTCCGCTTCCATGA-1	c2:aneuploid:low.conf
TGTTCCGGCCTGAGCT-1	c2:aneuploid:low.conf
TGTTCGTATTGCGGTG-1	c2:aneuploid:low.conf
TGTTCTCTACTCCCTA-1	c2:aneuploid:low.conf
TGTTCTTCCATTGACT-1	c2:aneuploid:low.conf
TGTTGCCGTCGTCCCA-1	c2:aneuploid:low.conf
TGTTGTCAAGAAGTCT-1	c2:aneuploid:low.conf
TGTTTAATACTTCATC-1	c2:aneuploid:low.conf
TGTTTCGGTACTTCTC-1	c2:aneuploid:low.conf
TGTTTGAGATCGTCAG-1	c2:aneuploid:low.conf
TTAAACAGAGTCCCGC-1	c2:aneuploid:low.conf
TTAAACCGGTAGCGAC-1	c2:aneuploid:low.conf
TTAAACTCGAATTCAT-1	c2:aneuploid:low.conf
TTAAAGGCGATGCTCG-1	c2:aneuploid:low.conf
TTAAAGTAAGTCGCCA-1	c1:diploid:low.conf
TTAACACCTCGAACAT-1	c2:aneuploid:low.conf
TTAACCAACCCTCCCT-1	c2:aneuploid:low.conf
TTAACGAACAAGCAGT-1	c2:aneuploid:low.conf
TTAACGTCGCAAGACC-1	c2:aneuploid:low.conf
TTAACTCACGCGTGGA-1	c2:aneuploid:low.conf
TTAAGACGAACGAACC-1	c2:aneuploid:low.conf
TTAAGATACCCAGAGA-1	c2:aneuploid:low.conf
TTAAGATAGGATTGAC-1	c2:aneuploid:low.conf
TTAAGCCGACAACTTC-1	c2:aneuploid:low.conf
TTAAGCGCCTGACCCA-1	c2:aneuploid:low.conf
TTAAGGATACGGAGGT-1	c2:aneuploid:low.conf
TTAAGTATTGTTATCC-1	c1:diploid:low.conf
TTAATCAGTACGTCAG-1	c2:aneuploid:low.conf
TTAATGCGAGGTAACT-1	c2:aneuploid:low.conf
TTAATGTAGACCAGGT-1	c2:aneuploid:low.conf
TTAATTGCTTTGGGTG-1	c2:aneuploid:low.conf
TTAATTTCAGACGCGG-1	c2:aneuploid:low.conf
TTACAACTACGCATCC-1	c2:aneuploid:low.conf
TTACAGACCTAAATGA-1	c2:aneuploid:low.conf
TTACATCGTGGCCTGG-1	c2:aneuploid:low.conf
TTACATGCCACAACTA-1	c2:aneuploid:low.conf
TTACCCATTGCCGGGT-1	c2:aneuploid:low.conf
TTACCCTAACAGTCCT-1	c2:aneuploid:low.conf
TTACCCTAGGGATTGG-1	c2:aneuploid:low.conf
TTACCGCCTTAGGGAA-1	c2:aneuploid:low.conf
TTACGGATGGTTCGAG-1	c2:aneuploid:low.conf
TTACTAAAGGACTTTA-1	c2:aneuploid:low.conf
TTACTCCGGCCGGGAA-1	c2:aneuploid:low.conf
TTACTGGGATATTTCA-1	c2:aneuploid:low.conf
TTACTGTCTAGAGCTC-1	c2:aneuploid:low.conf
TTACTGTTTCTCTACG-1	c2:aneuploid:low.conf
TTAGAAGAACATGACT-1	c2:aneuploid:low.conf
TTAGAATAAGGGTCGG-1	c2:aneuploid:low.conf
TTAGACACGATCGTTG-1	c2:aneuploid:low.conf
TTAGACGAGTCACCTC-1	c1:diploid:low.conf
TTAGAGTATTGTCGAG-1	c2:aneuploid:low.conf
TTAGAGTTTAGAAGGA-1	c2:aneuploid:low.conf
TTAGATAGGTCGATAC-1	c2:aneuploid:low.conf
TTAGCAACATGGATGT-1	c2:aneuploid:low.conf
TTAGCCATAGGGCTCG-1	c2:aneuploid:low.conf
TTAGCTAATACGATCT-1	c2:aneuploid:low.conf
TTAGCTGATTTGCCGT-1	c2:aneuploid:low.conf
TTAGGATGGGAGGGTA-1	c2:aneuploid:low.conf
TTAGGTCATAACCGAC-1	c2:aneuploid:low.conf
TTAGTAAACCTGCTCT-1	c1:diploid:low.conf
TTAGTTATTCGTGGCA-1	c2:aneuploid:low.conf
TTAGTTCAAGTGTTCG-1	c2:aneuploid:low.conf
TTATAGATGCACATTA-1	c2:aneuploid:low.conf
TTATAGGTAATTGTCT-1	c2:aneuploid:low.conf
TTATAGTCCAAGGTGC-1	c2:aneuploid:low.conf
TTATATACGCTGTCAC-1	c2:aneuploid:low.conf
TTATATTTGGCAATCC-1	c2:aneuploid:low.conf
TTATCCAATCGAACTC-1	c2:aneuploid:low.conf
TTATCCGGGATCTATA-1	c2:aneuploid:low.conf
TTATCGCCTGCGAAGC-1	c2:aneuploid:low.conf
TTATCTGTATCATAAC-1	c2:aneuploid:low.conf
TTATGAATGAAAGGGA-1	c2:aneuploid:low.conf
TTATGACAAACTGGAT-1	c2:aneuploid:low.conf
TTATGATCTTAACGAA-1	c2:aneuploid:low.conf
TTATGCGTCCCGGTCC-1	c2:aneuploid:low.conf
TTATGTTTGCGATAGA-1	c1:diploid:low.conf
TTATTAGAGCGTGTTC-1	c2:aneuploid:low.conf
TTATTAGGGAAGCATC-1	c2:aneuploid:low.conf
TTCAAAGTCTCTAGCC-1	c2:aneuploid:low.conf
TTCAACGACCCGACCG-1	c2:aneuploid:low.conf
TTCAAGCCGAGCTGAG-1	c2:aneuploid:low.conf
TTCAATACTCTGAATC-1	c2:aneuploid:low.conf
TTCAATTAGCCATAAT-1	c2:aneuploid:low.conf
TTCACGAAAGGATCAC-1	c2:aneuploid:low.conf
TTCACGGTCGTCACGT-1	c2:aneuploid:low.conf
TTCACTCGAGCACCTA-1	c2:aneuploid:low.conf
TTCACTTCCTAGAACG-1	c2:aneuploid:low.conf
TTCAGCCCTGGTCCAC-1	c2:aneuploid:low.conf
TTCAGCTGGCGTGCCC-1	c2:aneuploid:low.conf
TTCAGTTCAAGAGGAG-1	c2:aneuploid:low.conf
TTCATAGCCTTGTAAC-1	c2:aneuploid:low.conf
TTCATGGCGCAACAGG-1	c2:aneuploid:low.conf
TTCCAATCAGAGCTAG-1	c2:aneuploid:low.conf
TTCCAATCTGGCTATC-1	c2:aneuploid:low.conf
TTCCACACAGATTTGA-1	c2:aneuploid:low.conf
TTCCAGACGAGATTTA-1	c2:aneuploid:low.conf
TTCCAGTGGGTTTCGT-1	c2:aneuploid:low.conf
TTCCATCATGCGGTGA-1	c2:aneuploid:low.conf
TTCCATCGACAGCGTG-1	c2:aneuploid:low.conf
TTCCGCAGAGAAATAT-1	c1:diploid:low.conf
TTCCGCGTGAGGCGAT-1	c2:aneuploid:low.conf
TTCCGGCCTTGAGGCT-1	c1:diploid:low.conf
TTCCGGCTCGACTTCT-1	c2:aneuploid:low.conf
TTCCGGTATCTGTGTC-1	c2:aneuploid:low.conf
TTCCGGTTACCCACTT-1	c2:aneuploid:low.conf
TTCCTCGAGGGTGTCT-1	c2:aneuploid:low.conf
TTCCTCGGACTAACCA-1	c2:aneuploid:low.conf
TTCCTTTCTGTGTTGC-1	c2:aneuploid:low.conf
TTCGAACGAAACATGC-1	c2:aneuploid:low.conf
TTCGACAGAGCCCGTG-1	c2:aneuploid:low.conf
TTCGAGCCGGCGCTAC-1	c2:aneuploid:low.conf
TTCGCACTGTACGACA-1	c2:aneuploid:low.conf
TTCGCATCCGGAAGCA-1	c2:aneuploid:low.conf
TTCGCGCGCCATACGA-1	c2:aneuploid:low.conf
TTCGCTAGGAAGTTGT-1	c2:aneuploid:low.conf
TTCGCTATCTGACGTG-1	c1:diploid:low.conf
TTCGGACTGATGCCTT-1	c2:aneuploid:low.conf
TTCGGCAACCCGCTGA-1	c2:aneuploid:low.conf
TTCGGCTAGAGATGGT-1	c2:aneuploid:low.conf
TTCGGGACTAATCGCG-1	c2:aneuploid:low.conf
TTCGGGCGCTAGTCTT-1	c1:diploid:low.conf
TTCGGTACTGTAGAGG-1	c2:aneuploid:low.conf
TTCGGTGGAGACGCCC-1	c2:aneuploid:low.conf
TTCGTAATCCCAGCGG-1	c2:aneuploid:low.conf
TTCGTACTCCAGAACG-1	c2:aneuploid:low.conf
TTCGTGCATGTTATAG-1	c1:diploid:low.conf
TTCGTTCAACGAAGTT-1	c1:diploid:low.conf
TTCTAACCGAAGCTTA-1	c2:aneuploid:low.conf
TTCTACCTCAATCGGT-1	c1:diploid:low.conf
TTCTACCTTTATGTTG-1	c2:aneuploid:low.conf
TTCTACTTGCGAGGGC-1	c2:aneuploid:low.conf
TTCTAGAAAGTCTTAT-1	c2:aneuploid:low.conf
TTCTAGGCCAATTGTG-1	c2:aneuploid:low.conf
TTCTATGCCTTTCGCA-1	c2:aneuploid:low.conf
TTCTATTAAACGCAGC-1	c2:aneuploid:low.conf
TTCTGACCGGGCTCAA-1	c2:aneuploid:low.conf
TTCTGCCGCGCCTAGA-1	c2:aneuploid:low.conf
TTCTGCGGGTTAGCGG-1	c2:aneuploid:low.conf
TTCTGCTAGACTCCAA-1	c1:diploid:low.conf
TTCTTAGTGAACGGTG-1	c2:aneuploid:low.conf
TTCTTAGTGGCTCAGA-1	c2:aneuploid:low.conf
TTCTTATCCGCTGGGT-1	c2:aneuploid:low.conf
TTCTTCCCTTTGATAT-1	c2:aneuploid:low.conf
TTCTTGAGCCGCGCTA-1	c1:diploid:low.conf
TTCTTGCTAGCATCTC-1	c2:aneuploid:low.conf
TTCTTGGACGATCTGC-1	c2:aneuploid:low.conf
TTCTTGGAGTAATGAG-1	c2:aneuploid:low.conf
TTCTTGTAACCTAATG-1	c2:aneuploid:low.conf
TTCTTTGGTCGCGACG-1	c2:aneuploid:low.conf
TTGAAAGGTGTAAAGG-1	c2:aneuploid:low.conf
TTGAACGAATCCTTTG-1	c2:aneuploid:low.conf
TTGAACGACGTGCTGA-1	c2:aneuploid:low.conf
TTGAAGAATTCCCAGG-1	c1:diploid:low.conf
TTGAATATGGACTTTC-1	c2:aneuploid:low.conf
TTGAATTCACGTGAGG-1	c2:aneuploid:low.conf
TTGACAGGAGCTCCCG-1	c2:aneuploid:low.conf
TTGACCAGGAACAACT-1	c2:aneuploid:low.conf
TTGACCATGTTCTCCG-1	c2:aneuploid:low.conf
TTGACCGTGTTAATGA-1	c2:aneuploid:low.conf
TTGACGATTCAGCACG-1	c2:aneuploid:low.conf
TTGACGCTCCATGAGC-1	c2:aneuploid:low.conf
TTGACTACCATATGGT-1	c2:aneuploid:low.conf
TTGACTATTGTCCGGC-1	c2:aneuploid:low.conf
TTGAGAAGTTTAGCAT-1	c2:aneuploid:low.conf
TTGAGAGTACTGCTAA-1	c2:aneuploid:low.conf
TTGAGCAGCCCACGGT-1	c2:aneuploid:low.conf
TTGAGCGCCACGTGAT-1	c2:aneuploid:low.conf
TTGAGGCATTTAACTC-1	c2:aneuploid:low.conf
TTGAGTCCCGCTGCTG-1	c2:aneuploid:low.conf
TTGATAGTCAATACAT-1	c2:aneuploid:low.conf
TTGATCTAACTTTGTC-1	c2:aneuploid:low.conf
TTGATGCCGCTCGTCG-1	c2:aneuploid:low.conf
TTGATGTGTAGTCCCG-1	c2:aneuploid:low.conf
TTGATTAGCTGTTTCT-1	c1:diploid:low.conf
TTGATTATGCAGATGA-1	c2:aneuploid:low.conf
TTGCAAGAAGACTCCT-1	c2:aneuploid:low.conf
TTGCACAATTCAGAAA-1	c2:aneuploid:low.conf
TTGCACGGAGCAGCAC-1	c2:aneuploid:low.conf
TTGCCAAGCAGAACCC-1	c2:aneuploid:low.conf
TTGCCCTGATCACGGG-1	c2:aneuploid:low.conf
TTGCCGCTTTCTAGTA-1	c2:aneuploid:low.conf
TTGCCGGTGATCCCTC-1	c2:aneuploid:low.conf
TTGCCTAATCCAAAGT-1	c1:diploid:low.conf
TTGCCTTCTCGCCGGG-1	c1:diploid:low.conf
TTGCGCTTGATCAATA-1	c1:diploid:low.conf
TTGCGGAAAGCTGCCC-1	c1:diploid:low.conf
TTGCGGCATCAGAAAG-1	c2:aneuploid:low.conf
TTGCGGCGACTCATGC-1	c2:aneuploid:low.conf
TTGCGTAGTTTGAGGA-1	c2:aneuploid:low.conf
TTGCGTCGGCCAACCG-1	c2:aneuploid:low.conf
TTGCGTGAACGCTTAG-1	c2:aneuploid:low.conf
TTGCGTGTGTAGGCAT-1	c2:aneuploid:low.conf
TTGCTCATAGTACGTG-1	c1:diploid:low.conf
TTGCTCCCATACCGGA-1	c2:aneuploid:low.conf
TTGCTGAAGGAACCAC-1	c1:diploid:low.conf
TTGCTGATCATGTTCG-1	c2:aneuploid:low.conf
TTGCTGCACCTATCCA-1	c2:aneuploid:low.conf
TTGCTGGCCGGGCTTC-1	c2:aneuploid:low.conf
TTGGACCATCTGGCAA-1	c2:aneuploid:low.conf
TTGGACCTATAACAGT-1	c2:aneuploid:low.conf
TTGGAGTCTCCCTTCT-1	c2:aneuploid:low.conf
TTGGATATCGTCTACG-1	c2:aneuploid:low.conf
TTGGATCGACTTCTGG-1	c2:aneuploid:low.conf
TTGGATTGGGTACCAC-1	c2:aneuploid:low.conf
TTGGCCAAATTGTATC-1	c2:aneuploid:low.conf
TTGGCCATCTTGCGCT-1	c2:aneuploid:low.conf
TTGGCCTAGAATTTCG-1	c2:aneuploid:low.conf
TTGGCGATCCGAATAT-1	c2:aneuploid:low.conf
TTGGCTCGCATGAGAC-1	c2:aneuploid:low.conf
TTGGGAAGACGAGCCG-1	c2:aneuploid:low.conf
TTGGGACACTGCCCGC-1	c2:aneuploid:low.conf
TTGGGACGTAAGAGTT-1	c2:aneuploid:low.conf
TTGGGCGGCGGTTGCC-1	c2:aneuploid:low.conf
TTGGGTTTATTCAGCG-1	c2:aneuploid:low.conf
TTGGTATGGCTTGTGT-1	c2:aneuploid:low.conf
TTGGTCACACTCGTAA-1	c2:aneuploid:low.conf
TTGGTGCGGTGTTGAA-1	c2:aneuploid:low.conf
TTGGTTCGCTCAAAGG-1	c2:aneuploid:low.conf
TTGTAAGGCCAGTTGG-1	c2:aneuploid:low.conf
TTGTAATCCGTACTCG-1	c2:aneuploid:low.conf
TTGTATCACACAGAAT-1	c2:aneuploid:low.conf
TTGTCGTTCAGTTACC-1	c2:aneuploid:low.conf
TTGTCTCGGCAAGATG-1	c2:aneuploid:low.conf
TTGTGAACCTAATCCG-1	c2:aneuploid:low.conf
TTGTGATCTGTTCAGT-1	c1:diploid:low.conf
TTGTGCAGCCACGTCA-1	c2:aneuploid:low.conf
TTGTGGCCCTGACAGT-1	c2:aneuploid:low.conf
TTGTGGTATAGGTATG-1	c2:aneuploid:low.conf
TTGTGGTGGTACTAAG-1	c1:diploid:low.conf
TTGTGTATGCCACCAA-1	c2:aneuploid:low.conf
TTGTGTTTCCCGAAAG-1	c2:aneuploid:low.conf
TTGTTAGCAAATTCGA-1	c2:aneuploid:low.conf
TTGTTCAGTGTGCTAC-1	c2:aneuploid:low.conf
TTGTTGGCAATGACTG-1	c2:aneuploid:low.conf
TTGTTGTGTGTCAAGA-1	c2:aneuploid:low.conf
TTGTTTCACATCCAGG-1	c1:diploid:low.conf
TTGTTTCATTAGTCTA-1	c2:aneuploid:low.conf
TTGTTTGTATTACACG-1	c1:diploid:low.conf
TTGTTTGTGTAAATTC-1	c2:aneuploid:low.conf
GCAGATCCTCGCAAAT-1	not.defined
GCATCGGCCGTGTAGG-1	not.defined
TCGTGTATTGGTCACG-1	not.defined
